id,Region,Year,male_participants,female_participants,total_participants,male_participation_rate,female_participation_rate
1936_AFG,AFG,1936,15,0,15,1,0
1948_AFG,AFG,1948,25,0,25,1,0
1956_AFG,AFG,1956,12,0,12,1,0
1960_AFG,AFG,1960,12,0,12,1,0
1964_AFG,AFG,1964,8,0,8,1,0
1968_AFG,AFG,1968,5,0,5,1,0
1972_AFG,AFG,1972,8,0,8,1,0
1980_AFG,AFG,1980,11,0,11,1,0
1988_AFG,AFG,1988,5,0,5,1,0
1996_AFG,AFG,1996,2,0,2,1,0
2004_AFG,AFG,2004,3,2,5,0.6,0.4
2008_AFG,AFG,2008,3,1,4,0.75,0.25
2012_AFG,AFG,2012,5,1,6,0.833,0.167
2016_AFG,AFG,2016,2,1,3,0.667,0.333
1952_AHO,AHO,1952,11,0,11,1,0
1960_AHO,AHO,1960,5,0,5,1,0
1964_AHO,AHO,1964,4,0,4,1,0
1968_AHO,AHO,1968,3,2,5,0.6,0.4
1972_AHO,AHO,1972,2,0,2,1,0
1976_AHO,AHO,1976,4,0,4,1,0
1984_AHO,AHO,1984,3,5,8,0.375,0.625
1988_AHO,AHO,1988,4,1,5,0.8,0.2
1992_AHO,AHO,1992,5,1,6,0.833,0.167
1996_AHO,AHO,1996,6,0,6,1,0
2000_AHO,AHO,2000,6,1,7,0.857,0.143
2004_AHO,AHO,2004,3,0,3,1,0
2008_AHO,AHO,2008,3,0,3,1,0
1972_ALB,ALB,1972,4,1,5,0.8,0.2
1992_ALB,ALB,1992,5,2,7,0.714,0.286
1996_ALB,ALB,1996,3,4,7,0.429,0.571
2000_ALB,ALB,2000,2,2,4,0.5,0.5
2004_ALB,ALB,2004,5,2,7,0.714,0.286
2008_ALB,ALB,2008,7,4,11,0.636,0.364
2012_ALB,ALB,2012,6,3,9,0.667,0.333
2016_ALB,ALB,2016,3,3,6,0.5,0.5
1964_ALG,ALG,1964,1,0,1,1,0
1968_ALG,ALG,1968,3,0,3,1,0
1972_ALG,ALG,1972,5,0,5,1,0
1980_ALG,ALG,1980,54,0,54,1,0
1984_ALG,ALG,1984,33,0,33,1,0
1988_ALG,ALG,1988,40,2,42,0.952,0.048
1992_ALG,ALG,1992,36,3,39,0.923,0.077
1996_ALG,ALG,1996,39,6,45,0.867,0.133
2000_ALG,ALG,2000,37,10,47,0.787,0.213
2004_ALG,ALG,2004,46,15,61,0.754,0.246
2008_ALG,ALG,2008,34,22,56,0.607,0.393
2012_ALG,ALG,2012,21,17,38,0.553,0.447
2016_ALG,ALG,2016,54,10,64,0.844,0.156
1976_AND,AND,1976,8,0,8,1,0
1980_AND,AND,1980,5,0,5,1,0
1984_AND,AND,1984,4,0,4,1,0
1988_AND,AND,1988,5,2,7,0.714,0.286
1992_AND,AND,1992,11,2,13,0.846,0.154
1996_AND,AND,1996,6,2,8,0.75,0.25
2000_AND,AND,2000,3,2,5,0.6,0.4
2004_AND,AND,2004,4,2,6,0.667,0.333
2008_AND,AND,2008,3,2,5,0.6,0.4
2012_AND,AND,2012,4,2,6,0.667,0.333
2016_AND,AND,2016,2,2,4,0.5,0.5
1980_ANG,ANG,1980,10,1,11,0.909,0.091
1988_ANG,ANG,1988,19,5,24,0.792,0.208
1992_ANG,ANG,1992,25,3,28,0.893,0.107
1996_ANG,ANG,1996,13,15,28,0.464,0.536
2000_ANG,ANG,2000,15,15,30,0.5,0.5
2004_ANG,ANG,2004,14,16,30,0.467,0.533
2008_ANG,ANG,2008,17,15,32,0.531,0.469
2012_ANG,ANG,2012,4,29,33,0.121,0.879
2016_ANG,ANG,2016,8,18,26,0.308,0.692
1976_ANT,ANT,1976,10,0,10,1,0
1984_ANT,ANT,1984,10,4,14,0.714,0.286
1988_ANT,ANT,1988,12,3,15,0.8,0.2
1992_ANT,ANT,1992,9,4,13,0.692,0.308
1996_ANT,ANT,1996,8,5,13,0.615,0.385
2000_ANT,ANT,2000,2,1,3,0.667,0.333
2004_ANT,ANT,2004,3,2,5,0.6,0.4
2008_ANT,ANT,2008,4,1,5,0.8,0.2
2012_ANT,ANT,2012,2,2,4,0.5,0.5
2016_ANT,ANT,2016,6,2,8,0.75,0.25
1908_ANZ,ANZ,1908,30,0,30,1,0
1912_ANZ,ANZ,1912,23,2,25,0.92,0.08
1900_ARG,ARG,1900,1,0,1,1,0
1908_ARG,ARG,1908,1,0,1,1,0
1920_ARG,ARG,1920,1,0,1,1,0
1924_ARG,ARG,1924,77,0,77,1,0
1928_ARG,ARG,1928,91,0,91,1,0
1932_ARG,ARG,1932,33,0,33,1,0
1936_ARG,ARG,1936,50,1,51,0.98,0.02
1948_ARG,ARG,1948,197,11,208,0.947,0.053
1952_ARG,ARG,1952,126,9,135,0.933,0.067
1956_ARG,ARG,1956,34,1,35,0.971,0.029
1960_ARG,ARG,1960,96,2,98,0.98,0.02
1964_ARG,ARG,1964,107,7,114,0.939,0.061
1968_ARG,ARG,1968,86,8,94,0.915,0.085
1972_ARG,ARG,1972,90,4,94,0.957,0.043
1976_ARG,ARG,1976,73,4,77,0.948,0.052
1980_ARG,ARG,1980,13,0,13,1,0
1984_ARG,ARG,1984,84,15,99,0.848,0.152
1988_ARG,ARG,1988,103,30,133,0.774,0.226
1992_ARG,ARG,1992,82,22,104,0.788,0.212
1996_ARG,ARG,1996,132,47,179,0.737,0.263
2000_ARG,ARG,2000,98,45,143,0.685,0.315
2004_ARG,ARG,2004,106,46,152,0.697,0.303
2008_ARG,ARG,2008,79,53,132,0.598,0.402
2012_ARG,ARG,2012,97,40,137,0.708,0.292
2016_ARG,ARG,2016,140,75,215,0.651,0.349
1996_ARM,ARM,1996,30,2,32,0.938,0.063
2000_ARM,ARM,2000,23,2,25,0.92,0.08
2004_ARM,ARM,2004,16,2,18,0.889,0.111
2008_ARM,ARM,2008,23,2,25,0.92,0.08
2012_ARM,ARM,2012,20,4,24,0.833,0.167
2016_ARM,ARM,2016,24,7,31,0.774,0.226
1988_ARU,ARU,1988,4,4,8,0.5,0.5
1992_ARU,ARU,1992,4,1,5,0.8,0.2
1996_ARU,ARU,1996,3,0,3,1,0
2000_ARU,ARU,2000,3,2,5,0.6,0.4
2004_ARU,ARU,2004,3,1,4,0.75,0.25
2008_ARU,ARU,2008,2,0,2,1,0
2012_ARU,ARU,2012,3,1,4,0.75,0.25
2016_ARU,ARU,2016,3,4,7,0.429,0.571
1988_ASA,ASA,1988,6,0,6,1,0
1992_ASA,ASA,1992,3,0,3,1,0
1996_ASA,ASA,1996,6,1,7,0.857,0.143
2000_ASA,ASA,2000,3,1,4,0.75,0.25
2004_ASA,ASA,2004,2,1,3,0.667,0.333
2008_ASA,ASA,2008,2,2,4,0.5,0.5
2012_ASA,ASA,2012,3,1,4,0.75,0.25
2016_ASA,ASA,2016,3,1,4,0.75,0.25
1896_AUS,AUS,1896,1,0,1,1,0
1900_AUS,AUS,1900,2,0,2,1,0
1904_AUS,AUS,1904,2,0,2,1,0
1920_AUS,AUS,1920,12,1,13,0.923,0.077
1924_AUS,AUS,1924,36,1,37,0.973,0.027
1928_AUS,AUS,1928,14,4,18,0.778,0.222
1932_AUS,AUS,1932,9,4,13,0.692,0.308
1936_AUS,AUS,1936,29,4,33,0.879,0.121
1948_AUS,AUS,1948,66,9,75,0.88,0.12
1952_AUS,AUS,1952,78,12,90,0.867,0.133
1956_AUS,AUS,1956,261,45,306,0.853,0.147
1960_AUS,AUS,1960,186,33,219,0.849,0.151
1964_AUS,AUS,1964,206,42,248,0.831,0.169
1968_AUS,AUS,1968,107,24,131,0.817,0.183
1972_AUS,AUS,1972,143,29,172,0.831,0.169
1976_AUS,AUS,1976,151,37,188,0.803,0.197
1980_AUS,AUS,1980,97,32,129,0.752,0.248
1984_AUS,AUS,1984,177,75,252,0.702,0.298
1988_AUS,AUS,1988,197,74,271,0.727,0.273
1992_AUS,AUS,1992,202,99,301,0.671,0.329
1996_AUS,AUS,1996,250,167,417,0.6,0.4
2000_AUS,AUS,2000,341,276,617,0.553,0.447
2004_AUS,AUS,2004,268,202,470,0.57,0.43
2008_AUS,AUS,2008,233,199,432,0.539,0.461
2012_AUS,AUS,2012,221,184,405,0.546,0.454
2016_AUS,AUS,2016,208,212,420,0.495,0.505
1896_AUT,AUT,1896,3,0,3,1,0
1900_AUT,AUT,1900,16,0,16,1,0
1904_AUT,AUT,1904,2,0,2,1,0
1908_AUT,AUT,1908,7,0,7,1,0
1912_AUT,AUT,1912,79,6,85,0.929,0.071
1924_AUT,AUT,1924,48,5,53,0.906,0.094
1928_AUT,AUT,1928,100,11,111,0.901,0.099
1932_AUT,AUT,1932,23,3,26,0.885,0.115
1936_AUT,AUT,1936,265,27,292,0.908,0.092
1948_AUT,AUT,1948,157,44,201,0.781,0.219
1952_AUT,AUT,1952,121,29,150,0.807,0.193
1956_AUT,AUT,1956,79,15,94,0.84,0.16
1960_AUT,AUT,1960,99,30,129,0.767,0.233
1964_AUT,AUT,1964,114,25,139,0.82,0.18
1968_AUT,AUT,1968,98,21,119,0.824,0.176
1972_AUT,AUT,1972,126,25,151,0.834,0.166
1976_AUT,AUT,1976,117,20,137,0.854,0.146
1980_AUT,AUT,1980,97,29,126,0.77,0.23
1984_AUT,AUT,1984,128,38,166,0.771,0.229
1988_AUT,AUT,1988,132,22,154,0.857,0.143
1992_AUT,AUT,1992,116,44,160,0.725,0.275
1996_AUT,AUT,1996,56,16,72,0.778,0.222
2000_AUT,AUT,2000,55,37,92,0.598,0.402
2004_AUT,AUT,2004,54,20,74,0.73,0.27
2008_AUT,AUT,2008,40,30,70,0.571,0.429
2012_AUT,AUT,2012,39,31,70,0.557,0.443
2016_AUT,AUT,2016,37,34,71,0.521,0.479
1996_AZE,AZE,1996,20,3,23,0.87,0.13
2000_AZE,AZE,2000,25,6,31,0.806,0.194
2004_AZE,AZE,2004,30,6,36,0.833,0.167
2008_AZE,AZE,2008,30,14,44,0.682,0.318
2012_AZE,AZE,2012,38,14,52,0.731,0.269
2016_AZE,AZE,2016,42,14,56,0.75,0.25
1952_BAH,BAH,1952,7,0,7,1,0
1956_BAH,BAH,1956,4,0,4,1,0
1960_BAH,BAH,1960,13,0,13,1,0
1964_BAH,BAH,1964,11,0,11,1,0
1968_BAH,BAH,1968,16,0,16,1,0
1972_BAH,BAH,1972,19,1,20,0.95,0.05
1976_BAH,BAH,1976,10,1,11,0.909,0.091
1984_BAH,BAH,1984,17,5,22,0.773,0.227
1988_BAH,BAH,1988,12,4,16,0.75,0.25
1992_BAH,BAH,1992,12,2,14,0.857,0.143
1996_BAH,BAH,1996,19,7,26,0.731,0.269
2000_BAH,BAH,2000,16,9,25,0.64,0.36
2004_BAH,BAH,2004,13,9,22,0.591,0.409
2008_BAH,BAH,2008,16,9,25,0.64,0.36
2012_BAH,BAH,2012,12,9,21,0.571,0.429
2016_BAH,BAH,2016,17,12,29,0.586,0.414
1984_BAN,BAN,1984,1,0,1,1,0
1988_BAN,BAN,1988,6,0,6,1,0
1992_BAN,BAN,1992,5,1,6,0.833,0.167
1996_BAN,BAN,1996,3,1,4,0.75,0.25
2000_BAN,BAN,2000,2,3,5,0.4,0.6
2004_BAN,BAN,2004,3,1,4,0.75,0.25
2008_BAN,BAN,2008,3,2,5,0.6,0.4
2012_BAN,BAN,2012,4,1,5,0.8,0.2
2016_BAN,BAN,2016,4,3,7,0.571,0.429
1968_BAR,BAR,1968,9,0,9,1,0
1972_BAR,BAR,1972,8,5,13,0.615,0.385
1976_BAR,BAR,1976,9,2,11,0.818,0.182
1984_BAR,BAR,1984,13,3,16,0.813,0.188
1988_BAR,BAR,1988,16,1,17,0.941,0.059
1992_BAR,BAR,1992,16,1,17,0.941,0.059
1996_BAR,BAR,1996,11,2,13,0.846,0.154
2000_BAR,BAR,2000,12,6,18,0.667,0.333
2004_BAR,BAR,2004,9,1,10,0.9,0.1
2008_BAR,BAR,2008,7,1,8,0.875,0.125
2012_BAR,BAR,2012,6,0,6,1,0
2016_BAR,BAR,2016,7,4,11,0.636,0.364
1996_BDI,BDI,1996,6,1,7,0.857,0.143
2000_BDI,BDI,2000,5,1,6,0.833,0.167
2004_BDI,BDI,2004,5,2,7,0.714,0.286
2008_BDI,BDI,2008,1,2,3,0.333,0.667
2012_BDI,BDI,2012,2,4,6,0.333,0.667
2016_BDI,BDI,2016,5,4,9,0.556,0.444
1900_BEL,BEL,1900,64,0,64,1,0
1908_BEL,BEL,1908,70,0,70,1,0
1912_BEL,BEL,1912,35,1,36,0.972,0.028
1920_BEL,BEL,1920,326,10,336,0.97,0.03
1924_BEL,BEL,1924,183,7,190,0.963,0.037
1928_BEL,BEL,1928,198,13,211,0.938,0.062
1932_BEL,BEL,1932,33,8,41,0.805,0.195
1936_BEL,BEL,1936,168,8,176,0.955,0.045
1948_BEL,BEL,1948,142,21,163,0.871,0.129
1952_BEL,BEL,1952,139,5,144,0.965,0.035
1956_BEL,BEL,1956,57,4,61,0.934,0.066
1960_BEL,BEL,1960,93,8,101,0.921,0.079
1964_BEL,BEL,1964,66,2,68,0.971,0.029
1968_BEL,BEL,1968,77,5,82,0.939,0.061
1972_BEL,BEL,1972,83,6,89,0.933,0.067
1976_BEL,BEL,1976,78,27,105,0.743,0.257
1980_BEL,BEL,1980,45,16,61,0.738,0.262
1984_BEL,BEL,1984,49,18,67,0.731,0.269
1988_BEL,BEL,1988,35,25,60,0.583,0.417
1992_BEL,BEL,1992,47,26,73,0.644,0.356
1996_BEL,BEL,1996,41,20,61,0.672,0.328
2000_BEL,BEL,2000,36,32,68,0.529,0.471
2004_BEL,BEL,2004,31,19,50,0.62,0.38
2008_BEL,BEL,2008,77,17,94,0.819,0.181
2012_BEL,BEL,2012,69,42,111,0.622,0.378
2016_BEL,BEL,2016,70,34,104,0.673,0.327
1972_BEN,BEN,1972,3,0,3,1,0
1980_BEN,BEN,1980,15,1,16,0.938,0.063
1984_BEN,BEN,1984,3,0,3,1,0
1988_BEN,BEN,1988,6,1,7,0.857,0.143
1992_BEN,BEN,1992,4,2,6,0.667,0.333
1996_BEN,BEN,1996,4,1,5,0.8,0.2
2000_BEN,BEN,2000,3,1,4,0.75,0.25
2004_BEN,BEN,2004,2,2,4,0.5,0.5
2008_BEN,BEN,2008,3,2,5,0.6,0.4
2012_BEN,BEN,2012,4,1,5,0.8,0.2
2016_BEN,BEN,2016,4,2,6,0.667,0.333
1936_BER,BER,1936,5,0,5,1,0
1948_BER,BER,1948,10,2,12,0.833,0.167
1952_BER,BER,1952,4,2,6,0.667,0.333
1956_BER,BER,1956,3,0,3,1,0
1960_BER,BER,1960,9,0,9,1,0
1964_BER,BER,1964,4,0,4,1,0
1968_BER,BER,1968,6,0,6,1,0
1972_BER,BER,1972,9,0,9,1,0
1976_BER,BER,1976,15,1,16,0.938,0.063
1984_BER,BER,1984,11,1,12,0.917,0.083
1988_BER,BER,1988,11,1,12,0.917,0.083
1992_BER,BER,1992,15,6,21,0.714,0.286
1996_BER,BER,1996,7,2,9,0.778,0.222
2000_BER,BER,2000,4,2,6,0.667,0.333
2004_BER,BER,2004,5,5,10,0.5,0.5
2008_BER,BER,2008,2,4,6,0.333,0.667
2012_BER,BER,2012,5,3,8,0.625,0.375
2016_BER,BER,2016,4,4,8,0.5,0.5
1984_BHU,BHU,1984,3,3,6,0.5,0.5
1988_BHU,BHU,1988,3,0,3,1,0
1992_BHU,BHU,1992,3,3,6,0.5,0.5
1996_BHU,BHU,1996,1,1,2,0.5,0.5
2000_BHU,BHU,2000,1,1,2,0.5,0.5
2004_BHU,BHU,2004,1,1,2,0.5,0.5
2008_BHU,BHU,2008,1,1,2,0.5,0.5
2012_BHU,BHU,2012,0,2,2,0,1
2016_BHU,BHU,2016,0,2,2,0,1
1992_BIH,BIH,1992,6,4,10,0.6,0.4
1996_BIH,BIH,1996,7,2,9,0.778,0.222
2000_BIH,BIH,2000,7,2,9,0.778,0.222
2004_BIH,BIH,2004,7,2,9,0.778,0.222
2008_BIH,BIH,2008,4,1,5,0.8,0.2
2012_BIH,BIH,2012,4,2,6,0.667,0.333
2016_BIH,BIH,2016,7,4,11,0.636,0.364
1968_BIZ,BIZ,1968,7,0,7,1,0
1972_BIZ,BIZ,1972,1,0,1,1,0
1976_BIZ,BIZ,1976,4,0,4,1,0
1984_BIZ,BIZ,1984,11,0,11,1,0
1988_BIZ,BIZ,1988,10,0,10,1,0
1992_BIZ,BIZ,1992,9,1,10,0.9,0.1
1996_BIZ,BIZ,1996,2,3,5,0.4,0.6
2000_BIZ,BIZ,2000,1,1,2,0.5,0.5
2004_BIZ,BIZ,2004,1,1,2,0.5,0.5
2008_BIZ,BIZ,2008,3,1,4,0.75,0.25
2012_BIZ,BIZ,2012,2,1,3,0.667,0.333
2016_BIZ,BIZ,2016,2,1,3,0.667,0.333
1996_BLR,BLR,1996,91,66,157,0.58,0.42
2000_BLR,BLR,2000,72,67,139,0.518,0.482
2004_BLR,BLR,2004,82,69,151,0.543,0.457
2008_BLR,BLR,2008,93,84,177,0.525,0.475
2012_BLR,BLR,2012,89,71,160,0.556,0.444
2016_BLR,BLR,2016,53,67,120,0.442,0.558
1900_BOH,BOH,1900,6,1,7,0.857,0.143
1908_BOH,BOH,1908,19,0,19,1,0
1912_BOH,BOH,1912,43,0,43,1,0
1936_BOL,BOL,1936,2,0,2,1,0
1956_BOL,BOL,1956,1,0,1,1,0
1964_BOL,BOL,1964,1,0,1,1,0
1968_BOL,BOL,1968,4,0,4,1,0
1972_BOL,BOL,1972,11,0,11,1,0
1976_BOL,BOL,1976,4,0,4,1,0
1980_BOL,BOL,1980,3,0,3,1,0
1984_BOL,BOL,1984,13,1,14,0.929,0.071
1988_BOL,BOL,1988,12,1,13,0.923,0.077
1992_BOL,BOL,1992,13,5,18,0.722,0.278
1996_BOL,BOL,1996,6,2,8,0.75,0.25
2000_BOL,BOL,2000,3,2,5,0.6,0.4
2004_BOL,BOL,2004,4,3,7,0.571,0.429
2008_BOL,BOL,2008,4,3,7,0.571,0.429
2012_BOL,BOL,2012,3,2,5,0.6,0.4
2016_BOL,BOL,2016,6,6,12,0.5,0.5
1980_BOT,BOT,1980,7,0,7,1,0
1984_BOT,BOT,1984,7,0,7,1,0
1988_BOT,BOT,1988,8,0,8,1,0
1992_BOT,BOT,1992,6,0,6,1,0
1996_BOT,BOT,1996,7,0,7,1,0
2000_BOT,BOT,2000,7,0,7,1,0
2004_BOT,BOT,2004,10,1,11,0.909,0.091
2008_BOT,BOT,2008,9,2,11,0.818,0.182
2012_BOT,BOT,2012,3,1,4,0.75,0.25
2016_BOT,BOT,2016,9,3,12,0.75,0.25
1900_BRA,BRA,1900,1,0,1,1,0
1920_BRA,BRA,1920,19,0,19,1,0
1924_BRA,BRA,1924,12,0,12,1,0
1932_BRA,BRA,1932,58,1,59,0.983,0.017
1936_BRA,BRA,1936,67,6,73,0.918,0.082
1948_BRA,BRA,1948,59,11,70,0.843,0.157
1952_BRA,BRA,1952,92,5,97,0.948,0.052
1956_BRA,BRA,1956,46,1,47,0.979,0.021
1960_BRA,BRA,1960,71,1,72,0.986,0.014
1964_BRA,BRA,1964,60,1,61,0.984,0.016
1968_BRA,BRA,1968,73,3,76,0.961,0.039
1972_BRA,BRA,1972,78,3,81,0.963,0.037
1976_BRA,BRA,1976,72,7,79,0.911,0.089
1980_BRA,BRA,1980,91,15,106,0.858,0.142
1984_BRA,BRA,1984,126,21,147,0.857,0.143
1988_BRA,BRA,1988,127,33,160,0.794,0.206
1992_BRA,BRA,1992,138,51,189,0.73,0.27
1996_BRA,BRA,1996,156,65,221,0.706,0.294
2000_BRA,BRA,2000,106,92,198,0.535,0.465
2004_BRA,BRA,2004,124,119,243,0.51,0.49
2008_BRA,BRA,2008,139,129,268,0.519,0.481
2012_BRA,BRA,2012,131,117,248,0.528,0.472
2016_BRA,BRA,2016,255,207,462,0.552,0.448
1984_BRN,BRN,1984,10,0,10,1,0
1988_BRN,BRN,1988,7,0,7,1,0
1992_BRN,BRN,1992,10,0,10,1,0
1996_BRN,BRN,1996,5,0,5,1,0
2000_BRN,BRN,2000,2,2,4,0.5,0.5
2004_BRN,BRN,2004,7,3,10,0.7,0.3
2008_BRN,BRN,2008,11,3,14,0.786,0.214
2012_BRN,BRN,2012,4,8,12,0.333,0.667
2016_BRN,BRN,2016,20,13,33,0.606,0.394
1996_BRU,BRU,1996,1,0,1,1,0
2000_BRU,BRU,2000,2,0,2,1,0
2004_BRU,BRU,2004,1,0,1,1,0
2012_BRU,BRU,2012,2,1,3,0.667,0.333
2016_BRU,BRU,2016,2,1,3,0.667,0.333
1924_BUL,BUL,1924,24,0,24,1,0
1928_BUL,BUL,1928,5,0,5,1,0
1932_BUL,BUL,1932,2,0,2,1,0
1936_BUL,BUL,1936,33,0,33,1,0
1948_BUL,BUL,1948,4,0,4,1,0
1952_BUL,BUL,1952,64,9,73,0.877,0.123
1956_BUL,BUL,1956,50,4,54,0.926,0.074
1960_BUL,BUL,1960,93,12,105,0.886,0.114
1964_BUL,BUL,1964,59,11,70,0.843,0.157
1968_BUL,BUL,1968,104,14,118,0.881,0.119
1972_BUL,BUL,1972,110,24,134,0.821,0.179
1976_BUL,BUL,1976,134,53,187,0.717,0.283
1980_BUL,BUL,1980,191,88,279,0.685,0.315
1984_BUL,BUL,1984,15,1,16,0.938,0.063
1988_BUL,BUL,1988,129,70,199,0.648,0.352
1992_BUL,BUL,1992,109,59,168,0.649,0.351
1996_BUL,BUL,1996,74,36,110,0.673,0.327
2000_BUL,BUL,2000,52,39,91,0.571,0.429
2004_BUL,BUL,2004,49,46,95,0.516,0.484
2008_BUL,BUL,2008,43,27,70,0.614,0.386
2012_BUL,BUL,2012,37,26,63,0.587,0.413
2016_BUL,BUL,2016,29,22,51,0.569,0.431
1972_BUR,BUR,1972,1,0,1,1,0
1988_BUR,BUR,1988,5,1,6,0.833,0.167
1992_BUR,BUR,1992,4,0,4,1,0
1996_BUR,BUR,1996,3,2,5,0.6,0.4
2000_BUR,BUR,2000,3,1,4,0.75,0.25
2004_BUR,BUR,2004,3,2,5,0.6,0.4
2008_BUR,BUR,2008,3,3,6,0.5,0.5
2012_BUR,BUR,2012,2,3,5,0.4,0.6
2016_BUR,BUR,2016,3,2,5,0.6,0.4
1968_CAF,CAF,1968,1,0,1,1,0
1984_CAF,CAF,1984,3,0,3,1,0
1988_CAF,CAF,1988,15,0,15,1,0
1992_CAF,CAF,1992,13,2,15,0.867,0.133
1996_CAF,CAF,1996,3,2,5,0.6,0.4
2000_CAF,CAF,2000,1,2,3,0.333,0.667
2004_CAF,CAF,2004,2,2,4,0.5,0.5
2008_CAF,CAF,2008,2,1,3,0.667,0.333
2012_CAF,CAF,2012,3,3,6,0.5,0.5
2016_CAF,CAF,2016,3,3,6,0.5,0.5
1956_CAM,CAM,1956,2,0,2,1,0
1964_CAM,CAM,1964,13,0,13,1,0
1972_CAM,CAM,1972,8,1,9,0.889,0.111
1996_CAM,CAM,1996,3,2,5,0.6,0.4
2000_CAM,CAM,2000,2,2,4,0.5,0.5
2004_CAM,CAM,2004,2,2,4,0.5,0.5
2008_CAM,CAM,2008,2,2,4,0.5,0.5
2012_CAM,CAM,2012,3,3,6,0.5,0.5
2016_CAM,CAM,2016,2,4,6,0.333,0.667
1900_CAN,CAN,1900,4,0,4,1,0
1904_CAN,CAN,1904,56,0,56,1,0
1908_CAN,CAN,1908,87,0,87,1,0
1912_CAN,CAN,1912,37,0,37,1,0
1920_CAN,CAN,1920,52,0,52,1,0
1924_CAN,CAN,1924,76,1,77,0.987,0.013
1928_CAN,CAN,1928,82,10,92,0.891,0.109
1932_CAN,CAN,1932,123,21,144,0.854,0.146
1936_CAN,CAN,1936,101,25,126,0.802,0.198
1948_CAN,CAN,1948,130,25,155,0.839,0.161
1952_CAN,CAN,1952,128,18,146,0.877,0.123
1956_CAN,CAN,1956,108,23,131,0.824,0.176
1960_CAN,CAN,1960,108,21,129,0.837,0.163
1964_CAN,CAN,1964,138,32,170,0.812,0.188
1968_CAN,CAN,1968,165,43,208,0.793,0.207
1972_CAN,CAN,1972,187,68,255,0.733,0.267
1976_CAN,CAN,1976,299,144,443,0.675,0.325
1980_CAN,CAN,1980,41,18,59,0.695,0.305
1984_CAN,CAN,1984,303,171,474,0.639,0.361
1988_CAN,CAN,1988,305,135,440,0.693,0.307
1992_CAN,CAN,1992,258,145,403,0.64,0.36
1996_CAN,CAN,1996,152,151,303,0.502,0.498
2000_CAN,CAN,2000,150,144,294,0.51,0.49
2004_CAN,CAN,2004,130,132,262,0.496,0.504
2008_CAN,CAN,2008,186,146,332,0.56,0.44
2012_CAN,CAN,2012,119,154,273,0.436,0.564
2016_CAN,CAN,2016,127,183,310,0.41,0.59
1976_CAY,CAY,1976,2,0,2,1,0
1984_CAY,CAY,1984,7,1,8,0.875,0.125
1988_CAY,CAY,1988,7,1,8,0.875,0.125
1992_CAY,CAY,1992,10,0,10,1,0
1996_CAY,CAY,1996,8,1,9,0.889,0.111
2000_CAY,CAY,2000,1,2,3,0.333,0.667
2004_CAY,CAY,2004,3,2,5,0.6,0.4
2008_CAY,CAY,2008,3,1,4,0.75,0.25
2012_CAY,CAY,2012,4,0,4,1,0
2016_CAY,CAY,2016,3,2,5,0.6,0.4
1964_CGO,CGO,1964,2,0,2,1,0
1972_CGO,CGO,1972,6,0,6,1,0
1980_CGO,CGO,1980,9,14,23,0.391,0.609
1984_CGO,CGO,1984,8,1,9,0.889,0.111
1988_CGO,CGO,1988,5,2,7,0.714,0.286
1992_CGO,CGO,1992,6,1,7,0.857,0.143
1996_CGO,CGO,1996,3,2,5,0.6,0.4
2000_CGO,CGO,2000,3,2,5,0.6,0.4
2004_CGO,CGO,2004,2,3,5,0.4,0.6
2008_CGO,CGO,2008,3,2,5,0.6,0.4
2012_CGO,CGO,2012,4,3,7,0.571,0.429
2016_CGO,CGO,2016,7,3,10,0.7,0.3
1964_CHA,CHA,1964,2,0,2,1,0
1968_CHA,CHA,1968,3,0,3,1,0
1972_CHA,CHA,1972,4,0,4,1,0
1984_CHA,CHA,1984,3,0,3,1,0
1988_CHA,CHA,1988,6,0,6,1,0
1992_CHA,CHA,1992,5,1,6,0.833,0.167
1996_CHA,CHA,1996,3,1,4,0.75,0.25
2000_CHA,CHA,2000,1,1,2,0.5,0.5
2004_CHA,CHA,2004,0,1,1,0,1
2008_CHA,CHA,2008,1,1,2,0.5,0.5
2012_CHA,CHA,2012,0,2,2,0,1
2016_CHA,CHA,2016,1,1,2,0.5,0.5
1912_CHI,CHI,1912,14,0,14,1,0
1920_CHI,CHI,1920,2,0,2,1,0
1924_CHI,CHI,1924,13,0,13,1,0
1928_CHI,CHI,1928,38,0,38,1,0
1936_CHI,CHI,1936,39,1,40,0.975,0.025
1948_CHI,CHI,1948,54,4,58,0.931,0.069
1952_CHI,CHI,1952,58,4,62,0.935,0.065
1956_CHI,CHI,1956,34,2,36,0.944,0.056
1960_CHI,CHI,1960,13,1,14,0.929,0.071
1964_CHI,CHI,1964,19,0,19,1,0
1968_CHI,CHI,1968,22,3,25,0.88,0.12
1972_CHI,CHI,1972,9,2,11,0.818,0.182
1976_CHI,CHI,1976,12,0,12,1,0
1984_CHI,CHI,1984,54,2,56,0.964,0.036
1988_CHI,CHI,1988,21,1,22,0.955,0.045
1992_CHI,CHI,1992,14,3,17,0.824,0.176
1996_CHI,CHI,1996,16,5,21,0.762,0.238
2000_CHI,CHI,2000,43,7,50,0.86,0.14
2004_CHI,CHI,2004,16,6,22,0.727,0.273
2008_CHI,CHI,2008,20,6,26,0.769,0.231
2012_CHI,CHI,2012,21,14,35,0.6,0.4
2016_CHI,CHI,2016,25,17,42,0.595,0.405
1932_CHN,CHN,1932,1,0,1,1,0
1936_CHN,CHN,1936,52,2,54,0.963,0.037
1948_CHN,CHN,1948,30,1,31,0.968,0.032
1952_CHN,CHN,1952,1,0,1,1,0
1980_CHN,CHN,1980,13,11,24,0.542,0.458
1984_CHN,CHN,1984,153,99,252,0.607,0.393
1988_CHN,CHN,1988,155,131,286,0.542,0.458
1992_CHN,CHN,1992,129,147,276,0.467,0.533
1996_CHN,CHN,1996,111,183,294,0.378,0.622
2000_CHN,CHN,2000,91,180,271,0.336,0.664
2004_CHN,CHN,2004,136,247,383,0.355,0.645
2008_CHN,CHN,2008,310,289,599,0.518,0.482
2012_CHN,CHN,2012,160,215,375,0.427,0.573
2016_CHN,CHN,2016,151,241,392,0.385,0.615
1964_CIV,CIV,1964,9,0,9,1,0
1968_CIV,CIV,1968,10,0,10,1,0
1972_CIV,CIV,1972,11,0,11,1,0
1976_CIV,CIV,1976,7,1,8,0.875,0.125
1984_CIV,CIV,1984,14,1,15,0.933,0.067
1988_CIV,CIV,1988,11,17,28,0.393,0.607
1992_CIV,CIV,1992,8,5,13,0.615,0.385
1996_CIV,CIV,1996,10,1,11,0.909,0.091
2000_CIV,CIV,2000,7,7,14,0.5,0.5
2004_CIV,CIV,2004,2,3,5,0.4,0.6
2008_CIV,CIV,2008,19,2,21,0.905,0.095
2012_CIV,CIV,2012,4,5,9,0.444,0.556
2016_CIV,CIV,2016,5,7,12,0.417,0.583
1964_CMR,CMR,1964,1,0,1,1,0
1968_CMR,CMR,1968,5,0,5,1,0
1972_CMR,CMR,1972,11,0,11,1,0
1976_CMR,CMR,1976,4,0,4,1,0
1980_CMR,CMR,1980,22,3,25,0.88,0.12
1984_CMR,CMR,1984,42,4,46,0.913,0.087
1988_CMR,CMR,1988,13,2,15,0.867,0.133
1992_CMR,CMR,1992,3,5,8,0.375,0.625
1996_CMR,CMR,1996,11,4,15,0.733,0.267
2000_CMR,CMR,2000,25,9,34,0.735,0.265
2004_CMR,CMR,2004,10,7,17,0.588,0.412
2008_CMR,CMR,2008,25,7,32,0.781,0.219
2012_CMR,CMR,2012,10,22,32,0.313,0.688
2016_CMR,CMR,2016,5,17,22,0.227,0.773
1968_COD,COD,1968,5,0,5,1,0
1984_COD,COD,1984,7,1,8,0.875,0.125
1988_COD,COD,1988,13,2,15,0.867,0.133
1992_COD,COD,1992,15,2,17,0.882,0.118
1996_COD,COD,1996,2,12,14,0.143,0.857
2000_COD,COD,2000,1,1,2,0.5,0.5
2004_COD,COD,2004,3,1,4,0.75,0.25
2008_COD,COD,2008,4,1,5,0.8,0.2
2012_COD,COD,2012,3,1,4,0.75,0.25
2016_COD,COD,2016,2,2,4,0.5,0.5
1988_COK,COK,1988,6,1,7,0.857,0.143
1992_COK,COK,1992,2,0,2,1,0
1996_COK,COK,1996,2,1,3,0.667,0.333
2000_COK,COK,2000,1,1,2,0.5,0.5
2004_COK,COK,2004,2,1,3,0.667,0.333
2008_COK,COK,2008,3,1,4,0.75,0.25
2012_COK,COK,2012,3,5,8,0.375,0.625
2016_COK,COK,2016,4,5,9,0.444,0.556
1900_COL,COL,1900,1,0,1,1,0
1932_COL,COL,1932,2,0,2,1,0
1936_COL,COL,1936,5,0,5,1,0
1948_COL,COL,1948,6,0,6,1,0
1956_COL,COL,1956,26,0,26,1,0
1960_COL,COL,1960,16,0,16,1,0
1964_COL,COL,1964,20,0,20,1,0
1968_COL,COL,1968,38,5,43,0.884,0.116
1972_COL,COL,1972,55,4,59,0.932,0.068
1976_COL,COL,1976,32,3,35,0.914,0.086
1980_COL,COL,1980,23,0,23,1,0
1984_COL,COL,1984,36,3,39,0.923,0.077
1988_COL,COL,1988,34,6,40,0.85,0.15
1992_COL,COL,1992,46,3,49,0.939,0.061
1996_COL,COL,1996,39,9,48,0.813,0.188
2000_COL,COL,2000,25,19,44,0.568,0.432
2004_COL,COL,2004,32,21,53,0.604,0.396
2008_COL,COL,2008,43,24,67,0.642,0.358
2012_COL,COL,2012,45,56,101,0.446,0.554
2016_COL,COL,2016,73,70,143,0.51,0.49
1996_COM,COM,1996,3,1,4,0.75,0.25
2000_COM,COM,2000,1,1,2,0.5,0.5
2004_COM,COM,2004,2,1,3,0.667,0.333
2008_COM,COM,2008,2,1,3,0.667,0.333
2012_COM,COM,2012,1,2,3,0.333,0.667
2016_COM,COM,2016,2,2,4,0.5,0.5
1996_CPV,CPV,1996,2,1,3,0.667,0.333
2000_CPV,CPV,2000,1,1,2,0.5,0.5
2004_CPV,CPV,2004,2,1,3,0.667,0.333
2008_CPV,CPV,2008,1,1,2,0.5,0.5
2012_CPV,CPV,2012,1,2,3,0.333,0.667
2016_CPV,CPV,2016,2,3,5,0.4,0.6
1936_CRC,CRC,1936,1,0,1,1,0
1964_CRC,CRC,1964,2,0,2,1,0
1968_CRC,CRC,1968,17,1,18,0.944,0.056
1972_CRC,CRC,1972,3,0,3,1,0
1976_CRC,CRC,1976,4,1,5,0.8,0.2
1980_CRC,CRC,1980,29,1,30,0.967,0.033
1984_CRC,CRC,1984,30,1,31,0.968,0.032
1988_CRC,CRC,1988,11,7,18,0.611,0.389
1992_CRC,CRC,1992,15,5,20,0.75,0.25
1996_CRC,CRC,1996,6,5,11,0.545,0.455
2000_CRC,CRC,2000,5,2,7,0.714,0.286
2004_CRC,CRC,2004,17,3,20,0.85,0.15
2008_CRC,CRC,2008,6,2,8,0.75,0.25
2012_CRC,CRC,2012,8,3,11,0.727,0.273
2016_CRC,CRC,2016,6,5,11,0.545,0.455
1992_CRO,CRO,1992,39,4,43,0.907,0.093
1996_CRO,CRO,1996,75,9,84,0.893,0.107
2000_CRO,CRO,2000,63,25,88,0.716,0.284
2004_CRO,CRO,2004,66,15,81,0.815,0.185
2008_CRO,CRO,2008,80,19,99,0.808,0.192
2012_CRO,CRO,2012,64,43,107,0.598,0.402
2016_CRO,CRO,2016,66,19,85,0.776,0.224
1900_CUB,CUB,1900,1,0,1,1,0
1904_CUB,CUB,1904,3,0,3,1,0
1924_CUB,CUB,1924,9,0,9,1,0
1928_CUB,CUB,1928,1,0,1,1,0
1932_CUB,CUB,1932,3,0,3,1,0
1948_CUB,CUB,1948,53,0,53,1,0
1952_CUB,CUB,1952,29,0,29,1,0
1956_CUB,CUB,1956,15,1,16,0.938,0.063
1960_CUB,CUB,1960,9,3,12,0.75,0.25
1964_CUB,CUB,1964,25,2,27,0.926,0.074
1968_CUB,CUB,1968,101,14,115,0.878,0.122
1972_CUB,CUB,1972,109,28,137,0.796,0.204
1976_CUB,CUB,1976,132,24,156,0.846,0.154
1980_CUB,CUB,1980,175,33,208,0.841,0.159
1992_CUB,CUB,1992,126,50,176,0.716,0.284
1996_CUB,CUB,1996,111,53,164,0.677,0.323
2000_CUB,CUB,2000,147,82,229,0.642,0.358
2004_CUB,CUB,2004,97,54,151,0.642,0.358
2008_CUB,CUB,2008,102,56,158,0.646,0.354
2012_CUB,CUB,2012,65,44,109,0.596,0.404
2016_CUB,CUB,2016,83,34,117,0.709,0.291
1980_CYP,CYP,1980,14,3,17,0.824,0.176
1984_CYP,CYP,1984,14,1,15,0.933,0.067
1988_CYP,CYP,1988,9,3,12,0.75,0.25
1992_CYP,CYP,1992,16,5,21,0.762,0.238
1996_CYP,CYP,1996,15,2,17,0.882,0.118
2000_CYP,CYP,2000,17,5,22,0.773,0.227
2004_CYP,CYP,2004,13,7,20,0.65,0.35
2008_CYP,CYP,2008,7,10,17,0.412,0.588
2012_CYP,CYP,2012,9,4,13,0.692,0.308
2016_CYP,CYP,2016,9,6,15,0.6,0.4
1996_CZE,CZE,1996,76,39,115,0.661,0.339
2000_CZE,CZE,2000,86,33,119,0.723,0.277
2004_CZE,CZE,2004,80,62,142,0.563,0.437
2008_CZE,CZE,2008,75,59,134,0.56,0.44
2012_CZE,CZE,2012,68,65,133,0.511,0.489
2016_CZE,CZE,2016,62,42,104,0.596,0.404
1896_DEN,DEN,1896,3,0,3,1,0
1900_DEN,DEN,1900,13,0,13,1,0
1908_DEN,DEN,1908,78,0,78,1,0
1912_DEN,DEN,1912,151,1,152,0.993,0.007
1920_DEN,DEN,1920,150,4,154,0.974,0.026
1924_DEN,DEN,1924,77,12,89,0.865,0.135
1928_DEN,DEN,1928,82,9,91,0.901,0.099
1932_DEN,DEN,1932,35,8,43,0.814,0.186
1936_DEN,DEN,1936,105,16,121,0.868,0.132
1948_DEN,DEN,1948,146,18,164,0.89,0.11
1952_DEN,DEN,1952,116,14,130,0.892,0.108
1956_DEN,DEN,1956,31,6,37,0.838,0.162
1960_DEN,DEN,1960,89,12,101,0.881,0.119
1964_DEN,DEN,1964,55,7,62,0.887,0.113
1968_DEN,DEN,1968,62,5,67,0.925,0.075
1972_DEN,DEN,1972,114,12,126,0.905,0.095
1976_DEN,DEN,1976,56,10,66,0.848,0.152
1980_DEN,DEN,1980,55,3,58,0.948,0.052
1984_DEN,DEN,1984,49,11,60,0.817,0.183
1988_DEN,DEN,1988,58,21,79,0.734,0.266
1992_DEN,DEN,1992,81,35,116,0.698,0.302
1996_DEN,DEN,1996,54,65,119,0.454,0.546
2000_DEN,DEN,2000,53,44,97,0.546,0.454
2004_DEN,DEN,2004,48,44,92,0.522,0.478
2008_DEN,DEN,2008,64,20,84,0.762,0.238
2012_DEN,DEN,2012,66,48,114,0.579,0.421
2016_DEN,DEN,2016,78,41,119,0.655,0.345
1984_DJI,DJI,1984,3,0,3,1,0
1988_DJI,DJI,1988,6,0,6,1,0
1992_DJI,DJI,1992,8,0,8,1,0
1996_DJI,DJI,1996,5,0,5,1,0
2000_DJI,DJI,2000,1,1,2,0.5,0.5
2008_DJI,DJI,2008,1,1,2,0.5,0.5
2012_DJI,DJI,2012,2,2,4,0.5,0.5
2016_DJI,DJI,2016,6,1,7,0.857,0.143
1996_DMA,DMA,1996,4,2,6,0.667,0.333
2000_DMA,DMA,2000,2,2,4,0.5,0.5
2004_DMA,DMA,2004,1,1,2,0.5,0.5
2008_DMA,DMA,2008,2,0,2,1,0
2012_DMA,DMA,2012,1,1,2,0.5,0.5
2016_DMA,DMA,2016,1,1,2,0.5,0.5
1964_DOM,DOM,1964,1,0,1,1,0
1968_DOM,DOM,1968,18,0,18,1,0
1972_DOM,DOM,1972,5,0,5,1,0
1976_DOM,DOM,1976,9,1,10,0.9,0.1
1980_DOM,DOM,1980,5,1,6,0.833,0.167
1984_DOM,DOM,1984,15,4,19,0.789,0.211
1988_DOM,DOM,1988,15,1,16,0.938,0.063
1992_DOM,DOM,1992,30,2,32,0.938,0.063
1996_DOM,DOM,1996,12,4,16,0.75,0.25
2000_DOM,DOM,2000,11,2,13,0.846,0.154
2004_DOM,DOM,2004,17,16,33,0.515,0.485
2008_DOM,DOM,2008,18,6,24,0.75,0.25
2012_DOM,DOM,2012,13,20,33,0.394,0.606
2016_DOM,DOM,2016,18,8,26,0.692,0.308
1924_ECU,ECU,1924,3,0,3,1,0
1968_ECU,ECU,1968,14,1,15,0.933,0.067
1972_ECU,ECU,1972,2,0,2,1,0
1976_ECU,ECU,1976,5,0,5,1,0
1980_ECU,ECU,1980,11,1,12,0.917,0.083
1984_ECU,ECU,1984,10,1,11,0.909,0.091
1988_ECU,ECU,1988,10,3,13,0.769,0.231
1992_ECU,ECU,1992,6,7,13,0.462,0.538
1996_ECU,ECU,1996,17,2,19,0.895,0.105
2000_ECU,ECU,2000,7,3,10,0.7,0.3
2004_ECU,ECU,2004,11,5,16,0.688,0.313
2008_ECU,ECU,2008,17,8,25,0.68,0.32
2012_ECU,ECU,2012,23,13,36,0.639,0.361
2016_ECU,ECU,2016,22,15,37,0.595,0.405
1920_EGY,EGY,1920,18,0,18,1,0
1924_EGY,EGY,1924,24,0,24,1,0
1928_EGY,EGY,1928,32,0,32,1,0
1936_EGY,EGY,1936,53,0,53,1,0
1948_EGY,EGY,1948,85,0,85,1,0
1952_EGY,EGY,1952,106,0,106,1,0
1956_EGY,EGY,1956,3,0,3,1,0
1964_EGY,EGY,1964,73,0,73,1,0
1968_EGY,EGY,1968,30,0,30,1,0
1972_EGY,EGY,1972,23,0,23,1,0
1976_EGY,EGY,1976,26,0,26,1,0
1984_EGY,EGY,1984,109,6,115,0.948,0.052
1988_EGY,EGY,1988,48,1,49,0.98,0.02
1992_EGY,EGY,1992,72,3,75,0.96,0.04
1996_EGY,EGY,1996,27,2,29,0.931,0.069
2000_EGY,EGY,2000,74,15,89,0.831,0.169
2004_EGY,EGY,2004,81,16,97,0.835,0.165
2008_EGY,EGY,2008,74,26,100,0.74,0.26
2012_EGY,EGY,2012,75,34,109,0.688,0.312
2016_EGY,EGY,2016,84,37,121,0.694,0.306
2000_ERI,ERI,2000,2,1,3,0.667,0.333
2004_ERI,ERI,2004,3,1,4,0.75,0.25
2008_ERI,ERI,2008,8,2,10,0.8,0.2
2012_ERI,ERI,2012,11,1,12,0.917,0.083
2016_ERI,ERI,2016,11,1,12,0.917,0.083
1932_ESA,ESA,1932,1,0,1,1,0
1968_ESA,ESA,1968,52,8,60,0.867,0.133
1972_ESA,ESA,1972,11,0,11,1,0
1984_ESA,ESA,1984,9,1,10,0.9,0.1
1988_ESA,ESA,1988,5,1,6,0.833,0.167
1992_ESA,ESA,1992,3,1,4,0.75,0.25
1996_ESA,ESA,1996,6,2,8,0.75,0.25
2000_ESA,ESA,2000,4,4,8,0.5,0.5
2004_ESA,ESA,2004,2,5,7,0.286,0.714
2008_ESA,ESA,2008,4,7,11,0.364,0.636
2012_ESA,ESA,2012,5,5,10,0.5,0.5
2016_ESA,ESA,2016,5,3,8,0.625,0.375
1900_ESP,ESP,1900,9,0,9,1,0
1920_ESP,ESP,1920,58,0,58,1,0
1924_ESP,ESP,1924,93,2,95,0.979,0.021
1928_ESP,ESP,1928,80,0,80,1,0
1932_ESP,ESP,1932,7,0,7,1,0
1936_ESP,ESP,1936,4,2,6,0.667,0.333
1948_ESP,ESP,1948,71,0,71,1,0
1952_ESP,ESP,1952,31,0,31,1,0
1956_ESP,ESP,1956,15,0,15,1,0
1960_ESP,ESP,1960,136,12,148,0.919,0.081
1964_ESP,ESP,1964,54,3,57,0.947,0.053
1968_ESP,ESP,1968,140,2,142,0.986,0.014
1972_ESP,ESP,1972,120,6,126,0.952,0.048
1976_ESP,ESP,1976,107,10,117,0.915,0.085
1980_ESP,ESP,1980,151,12,163,0.926,0.074
1984_ESP,ESP,1984,173,18,191,0.906,0.094
1988_ESP,ESP,1988,207,34,241,0.859,0.141
1992_ESP,ESP,1992,310,129,439,0.706,0.294
1996_ESP,ESP,1996,194,95,289,0.671,0.329
2000_ESP,ESP,2000,216,105,321,0.673,0.327
2004_ESP,ESP,2004,177,139,316,0.56,0.44
2008_ESP,ESP,2008,163,120,283,0.576,0.424
2012_ESP,ESP,2012,168,110,278,0.604,0.396
2016_ESP,ESP,2016,164,143,307,0.534,0.466
1920_EST,EST,1920,14,0,14,1,0
1924_EST,EST,1924,37,0,37,1,0
1928_EST,EST,1928,22,0,22,1,0
1932_EST,EST,1932,2,0,2,1,0
1936_EST,EST,1936,36,2,38,0.947,0.053
1992_EST,EST,1992,47,9,56,0.839,0.161
1996_EST,EST,1996,35,8,43,0.814,0.186
2000_EST,EST,2000,31,2,33,0.939,0.061
2004_EST,EST,2004,31,11,42,0.738,0.262
2008_EST,EST,2008,34,13,47,0.723,0.277
2012_EST,EST,2012,23,9,32,0.719,0.281
2016_EST,EST,2016,28,18,46,0.609,0.391
1956_ETH,ETH,1956,12,0,12,1,0
1960_ETH,ETH,1960,10,0,10,1,0
1964_ETH,ETH,1964,12,0,12,1,0
1968_ETH,ETH,1968,18,0,18,1,0
1972_ETH,ETH,1972,31,0,31,1,0
1980_ETH,ETH,1980,39,2,41,0.951,0.049
1992_ETH,ETH,1992,14,6,20,0.7,0.3
1996_ETH,ETH,1996,10,8,18,0.556,0.444
2000_ETH,ETH,2000,15,11,26,0.577,0.423
2004_ETH,ETH,2004,14,12,26,0.538,0.462
2008_ETH,ETH,2008,14,13,27,0.519,0.481
2012_ETH,ETH,2012,18,15,33,0.545,0.455
2016_ETH,ETH,2016,17,20,37,0.459,0.541
1992_EUN,EUN,1992,396,208,604,0.656,0.344
1956_FIJ,FIJ,1956,5,0,5,1,0
1960_FIJ,FIJ,1960,2,0,2,1,0
1968_FIJ,FIJ,1968,1,0,1,1,0
1972_FIJ,FIJ,1972,2,0,2,1,0
1976_FIJ,FIJ,1976,1,1,2,0.5,0.5
1984_FIJ,FIJ,1984,11,3,14,0.786,0.214
1988_FIJ,FIJ,1988,20,4,24,0.833,0.167
1992_FIJ,FIJ,1992,14,4,18,0.778,0.222
1996_FIJ,FIJ,1996,14,3,17,0.824,0.176
2000_FIJ,FIJ,2000,4,3,7,0.571,0.429
2004_FIJ,FIJ,2004,4,4,8,0.5,0.5
2008_FIJ,FIJ,2008,4,2,6,0.667,0.333
2012_FIJ,FIJ,2012,6,3,9,0.667,0.333
2016_FIJ,FIJ,2016,36,17,53,0.679,0.321
1908_FIN,FIN,1908,62,0,62,1,0
1912_FIN,FIN,1912,162,2,164,0.988,0.012
1920_FIN,FIN,1920,62,1,63,0.984,0.016
1924_FIN,FIN,1924,135,1,136,0.993,0.007
1928_FIN,FIN,1928,84,3,87,0.966,0.034
1932_FIN,FIN,1932,47,0,47,1,0
1936_FIN,FIN,1936,122,5,127,0.961,0.039
1948_FIN,FIN,1948,147,6,153,0.961,0.039
1952_FIN,FIN,1952,272,35,307,0.886,0.114
1956_FIN,FIN,1956,97,5,102,0.951,0.049
1960_FIN,FIN,1960,149,16,165,0.903,0.097
1964_FIN,FIN,1964,129,11,140,0.921,0.079
1968_FIN,FIN,1968,104,14,118,0.881,0.119
1972_FIN,FIN,1972,132,14,146,0.904,0.096
1976_FIN,FIN,1976,115,15,130,0.885,0.115
1980_FIN,FIN,1980,143,14,157,0.911,0.089
1984_FIN,FIN,1984,113,18,131,0.863,0.137
1988_FIN,FIN,1988,105,26,131,0.802,0.198
1992_FIN,FIN,1992,109,41,150,0.727,0.273
1996_FIN,FIN,1996,47,29,76,0.618,0.382
2000_FIN,FIN,2000,40,30,70,0.571,0.429
2004_FIN,FIN,2004,36,17,53,0.679,0.321
2008_FIN,FIN,2008,31,26,57,0.544,0.456
2012_FIN,FIN,2012,29,27,56,0.518,0.482
2016_FIN,FIN,2016,26,28,54,0.481,0.519
1896_FRA,FRA,1896,12,0,12,1,0
1900_FRA,FRA,1900,708,12,720,0.983,0.017
1904_FRA,FRA,1904,1,0,1,1,0
1908_FRA,FRA,1908,208,0,208,1,0
1912_FRA,FRA,1912,118,1,119,0.992,0.008
1920_FRA,FRA,1920,296,8,304,0.974,0.026
1924_FRA,FRA,1924,411,33,444,0.926,0.074
1928_FRA,FRA,1928,255,38,293,0.87,0.13
1932_FRA,FRA,1932,104,7,111,0.937,0.063
1936_FRA,FRA,1936,218,11,229,0.952,0.048
1948_FRA,FRA,1948,307,45,352,0.872,0.128
1952_FRA,FRA,1952,234,37,271,0.863,0.137
1956_FRA,FRA,1956,152,25,177,0.859,0.141
1960_FRA,FRA,1960,228,36,264,0.864,0.136
1964_FRA,FRA,1964,133,29,162,0.821,0.179
1968_FRA,FRA,1968,233,42,275,0.847,0.153
1972_FRA,FRA,1972,230,37,267,0.861,0.139
1976_FRA,FRA,1976,206,35,241,0.855,0.145
1980_FRA,FRA,1980,114,29,143,0.797,0.203
1984_FRA,FRA,1984,211,59,270,0.781,0.219
1988_FRA,FRA,1988,245,89,334,0.734,0.266
1992_FRA,FRA,1992,320,128,448,0.714,0.286
1996_FRA,FRA,1996,197,102,299,0.659,0.341
2000_FRA,FRA,2000,211,125,336,0.628,0.372
2004_FRA,FRA,2004,195,113,308,0.633,0.367
2008_FRA,FRA,2008,188,121,309,0.608,0.392
2012_FRA,FRA,2012,182,142,324,0.562,0.438
2016_FRA,FRA,2016,225,167,392,0.574,0.426
1968_FRG,FRG,1968,299,63,362,0.826,0.174
1972_FRG,FRG,1972,403,99,502,0.803,0.197
1976_FRG,FRG,1976,289,72,361,0.801,0.199
1980_FRG,FRG,1980,61,19,80,0.762,0.237
1984_FRG,FRG,1984,336,138,474,0.709,0.291
1988_FRG,FRG,1988,315,122,437,0.721,0.279
2000_FSM,FSM,2000,3,2,5,0.6,0.4
2004_FSM,FSM,2004,3,2,5,0.6,0.4
2008_FSM,FSM,2008,3,2,5,0.6,0.4
2012_FSM,FSM,2012,4,2,6,0.667,0.333
2016_FSM,FSM,2016,2,3,5,0.4,0.6
1972_GAB,GAB,1972,1,0,1,1,0
1984_GAB,GAB,1984,2,2,4,0.5,0.5
1988_GAB,GAB,1988,1,1,2,0.5,0.5
1992_GAB,GAB,1992,4,1,5,0.8,0.2
1996_GAB,GAB,1996,6,1,7,0.857,0.143
2000_GAB,GAB,2000,3,2,5,0.6,0.4
2004_GAB,GAB,2004,3,2,5,0.6,0.4
2008_GAB,GAB,2008,2,2,4,0.5,0.5
2012_GAB,GAB,2012,19,2,21,0.905,0.095
2016_GAB,GAB,2016,4,2,6,0.667,0.333
1984_GAM,GAM,1984,6,4,10,0.6,0.4
1988_GAM,GAM,1988,5,1,6,0.833,0.167
1992_GAM,GAM,1992,5,0,5,1,0
1996_GAM,GAM,1996,8,1,9,0.889,0.111
2000_GAM,GAM,2000,1,1,2,0.5,0.5
2004_GAM,GAM,2004,1,1,2,0.5,0.5
2008_GAM,GAM,2008,2,1,3,0.667,0.333
2012_GAM,GAM,2012,1,1,2,0.5,0.5
2016_GAM,GAM,2016,3,1,4,0.75,0.25
1896_GBR,GBR,1896,10,0,10,1,0
1900_GBR,GBR,1900,103,1,104,0.99,0.01
1904_GBR,GBR,1904,6,0,6,1,0
1908_GBR,GBR,1908,696,39,735,0.947,0.053
1912_GBR,GBR,1912,264,10,274,0.964,0.036
1920_GBR,GBR,1920,218,16,234,0.932,0.068
1924_GBR,GBR,1924,280,31,311,0.9,0.1
1928_GBR,GBR,1928,230,34,264,0.871,0.129
1932_GBR,GBR,1932,90,21,111,0.811,0.189
1936_GBR,GBR,1936,198,47,245,0.808,0.192
1948_GBR,GBR,1948,381,81,462,0.825,0.175
1952_GBR,GBR,1952,221,54,275,0.804,0.196
1956_GBR,GBR,1956,199,39,238,0.836,0.164
1960_GBR,GBR,1960,217,53,270,0.804,0.196
1964_GBR,GBR,1964,187,53,240,0.779,0.221
1968_GBR,GBR,1968,203,60,263,0.772,0.228
1972_GBR,GBR,1972,240,81,321,0.748,0.252
1976_GBR,GBR,1976,207,77,284,0.729,0.271
1980_GBR,GBR,1980,185,82,267,0.693,0.307
1984_GBR,GBR,1984,266,121,387,0.687,0.313
1988_GBR,GBR,1988,253,140,393,0.644,0.356
1992_GBR,GBR,1992,268,152,420,0.638,0.362
1996_GBR,GBR,1996,184,116,300,0.613,0.387
2000_GBR,GBR,2000,181,129,310,0.584,0.416
2004_GBR,GBR,2004,161,103,264,0.61,0.39
2008_GBR,GBR,2008,163,141,304,0.536,0.464
2012_GBR,GBR,2012,273,257,530,0.515,0.485
2016_GBR,GBR,2016,201,159,360,0.558,0.442
1996_GBS,GBS,1996,3,0,3,1,0
2000_GBS,GBS,2000,2,1,3,0.667,0.333
2004_GBS,GBS,2004,1,2,3,0.333,0.667
2008_GBS,GBS,2008,2,1,3,0.667,0.333
2012_GBS,GBS,2012,2,2,4,0.5,0.5
2016_GBS,GBS,2016,3,2,5,0.6,0.4
1968_GDR,GDR,1968,231,52,283,0.816,0.184
1972_GDR,GDR,1972,260,79,339,0.767,0.233
1976_GDR,GDR,1976,194,132,326,0.595,0.405
1980_GDR,GDR,1980,258,141,399,0.647,0.353
1984_GDR,GDR,1984,40,16,56,0.714,0.286
1988_GDR,GDR,1988,193,118,311,0.621,0.379
1996_GEO,GEO,1996,27,7,34,0.794,0.206
2000_GEO,GEO,2000,27,9,36,0.75,0.25
2004_GEO,GEO,2004,26,6,32,0.813,0.188
2008_GEO,GEO,2008,27,8,35,0.771,0.229
2012_GEO,GEO,2012,28,6,34,0.824,0.176
2016_GEO,GEO,2016,30,10,40,0.75,0.25
1984_GEQ,GEQ,1984,4,0,4,1,0
1988_GEQ,GEQ,1988,4,2,6,0.667,0.333
1992_GEQ,GEQ,1992,5,2,7,0.714,0.286
1996_GEQ,GEQ,1996,4,1,5,0.8,0.2
2000_GEQ,GEQ,2000,2,2,4,0.5,0.5
2004_GEQ,GEQ,2004,1,1,2,0.5,0.5
2008_GEQ,GEQ,2008,2,1,3,0.667,0.333
2012_GEQ,GEQ,2012,1,1,2,0.5,0.5
2016_GEQ,GEQ,2016,1,0,1,1,0
1896_GER,GER,1896,19,0,19,1,0
1900_GER,GER,1900,76,0,76,1,0
1904_GER,GER,1904,22,0,22,1,0
1908_GER,GER,1908,80,2,82,0.976,0.024
1912_GER,GER,1912,180,5,185,0.973,0.027
1928_GER,GER,1928,299,40,339,0.882,0.118
1932_GER,GER,1932,156,9,165,0.945,0.055
1936_GER,GER,1936,437,51,488,0.895,0.105
1952_GER,GER,1952,214,44,258,0.829,0.171
1956_GER,GER,1956,192,38,230,0.835,0.165
1960_GER,GER,1960,295,73,368,0.802,0.198
1964_GER,GER,1964,348,85,433,0.804,0.196
1992_GER,GER,1992,375,199,574,0.653,0.347
1996_GER,GER,1996,279,187,466,0.599,0.401
2000_GER,GER,2000,241,181,422,0.571,0.429
2004_GER,GER,2004,250,191,441,0.567,0.433
2008_GER,GER,2008,237,183,420,0.564,0.436
2012_GER,GER,2012,212,171,383,0.554,0.446
2016_GER,GER,2016,224,194,418,0.536,0.464
1952_GHA,GHA,1952,7,0,7,1,0
1960_GHA,GHA,1960,13,0,13,1,0
1964_GHA,GHA,1964,30,3,33,0.909,0.091
1968_GHA,GHA,1968,30,1,31,0.968,0.032
1972_GHA,GHA,1972,33,2,35,0.943,0.057
1984_GHA,GHA,1984,14,7,21,0.667,0.333
1988_GHA,GHA,1988,10,6,16,0.625,0.375
1992_GHA,GHA,1992,32,2,34,0.941,0.059
1996_GHA,GHA,1996,33,2,35,0.943,0.057
2000_GHA,GHA,2000,16,6,22,0.727,0.273
2004_GHA,GHA,2004,23,3,26,0.885,0.115
2008_GHA,GHA,2008,8,1,9,0.889,0.111
2012_GHA,GHA,2012,5,2,7,0.714,0.286
2016_GHA,GHA,2016,7,6,13,0.538,0.462
1896_GRE,GRE,1896,102,0,102,1,0
1900_GRE,GRE,1900,3,0,3,1,0
1904_GRE,GRE,1904,14,0,14,1,0
1908_GRE,GRE,1908,20,0,20,1,0
1912_GRE,GRE,1912,22,0,22,1,0
1920_GRE,GRE,1920,47,0,47,1,0
1924_GRE,GRE,1924,38,1,39,0.974,0.026
1928_GRE,GRE,1928,23,0,23,1,0
1932_GRE,GRE,1932,10,0,10,1,0
1936_GRE,GRE,1936,41,1,42,0.976,0.024
1948_GRE,GRE,1948,61,1,62,0.984,0.016
1952_GRE,GRE,1952,51,0,51,1,0
1956_GRE,GRE,1956,16,0,16,1,0
1960_GRE,GRE,1960,48,0,48,1,0
1964_GRE,GRE,1964,21,0,21,1,0
1968_GRE,GRE,1968,47,0,47,1,0
1972_GRE,GRE,1972,61,2,63,0.968,0.032
1976_GRE,GRE,1976,38,2,40,0.95,0.05
1980_GRE,GRE,1980,41,3,44,0.932,0.068
1984_GRE,GRE,1984,65,4,69,0.942,0.058
1988_GRE,GRE,1988,49,13,62,0.79,0.21
1992_GRE,GRE,1992,63,15,78,0.808,0.192
1996_GRE,GRE,1996,87,34,121,0.719,0.281
2000_GRE,GRE,2000,82,58,140,0.586,0.414
2004_GRE,GRE,2004,215,211,426,0.505,0.495
2008_GRE,GRE,2008,82,70,152,0.539,0.461
2012_GRE,GRE,2012,65,37,102,0.637,0.363
2016_GRE,GRE,2016,56,36,92,0.609,0.391
1984_GRN,GRN,1984,5,1,6,0.833,0.167
1988_GRN,GRN,1988,4,2,6,0.667,0.333
1992_GRN,GRN,1992,3,1,4,0.75,0.25
1996_GRN,GRN,1996,5,0,5,1,0
2000_GRN,GRN,2000,2,1,3,0.667,0.333
2004_GRN,GRN,2004,3,2,5,0.6,0.4
2008_GRN,GRN,2008,4,5,9,0.444,0.556
2012_GRN,GRN,2012,5,3,8,0.625,0.375
2016_GRN,GRN,2016,5,1,6,0.833,0.167
1932_GUA,GUA,1932,0,1,1,0,1
1952_GUA,GUA,1952,20,1,21,0.952,0.048
1968_GUA,GUA,1968,47,1,48,0.979,0.021
1972_GUA,GUA,1972,8,0,8,1,0
1976_GUA,GUA,1976,26,2,28,0.929,0.071
1980_GUA,GUA,1980,10,0,10,1,0
1984_GUA,GUA,1984,20,4,24,0.833,0.167
1988_GUA,GUA,1988,30,4,34,0.882,0.118
1992_GUA,GUA,1992,12,2,14,0.857,0.143
1996_GUA,GUA,1996,25,1,26,0.962,0.038
2000_GUA,GUA,2000,14,1,15,0.933,0.067
2004_GUA,GUA,2004,11,7,18,0.611,0.389
2008_GUA,GUA,2008,9,3,12,0.75,0.25
2012_GUA,GUA,2012,12,7,19,0.632,0.368
2016_GUA,GUA,2016,15,6,21,0.714,0.286
1968_GUI,GUI,1968,15,0,15,1,0
1980_GUI,GUI,1980,9,0,9,1,0
1984_GUI,GUI,1984,1,0,1,1,0
1988_GUI,GUI,1988,6,0,6,1,0
1992_GUI,GUI,1992,6,2,8,0.75,0.25
1996_GUI,GUI,1996,4,1,5,0.8,0.2
2000_GUI,GUI,2000,3,3,6,0.5,0.5
2004_GUI,GUI,2004,2,1,3,0.667,0.333
2008_GUI,GUI,2008,2,3,5,0.4,0.6
2012_GUI,GUI,2012,2,2,4,0.5,0.5
2016_GUI,GUI,2016,2,3,5,0.4,0.6
1988_GUM,GUM,1988,15,5,20,0.75,0.25
1992_GUM,GUM,1992,16,6,22,0.727,0.273
1996_GUM,GUM,1996,6,2,8,0.75,0.25
2000_GUM,GUM,2000,5,2,7,0.714,0.286
2004_GUM,GUM,2004,3,1,4,0.75,0.25
2008_GUM,GUM,2008,4,2,6,0.667,0.333
2012_GUM,GUM,2012,5,3,8,0.625,0.375
2016_GUM,GUM,2016,3,2,5,0.6,0.4
1948_GUY,GUY,1948,4,0,4,1,0
1952_GUY,GUY,1952,1,0,1,1,0
1956_GUY,GUY,1956,3,1,4,0.75,0.25
1960_GUY,GUY,1960,4,1,5,0.8,0.2
1964_GUY,GUY,1964,1,0,1,1,0
1968_GUY,GUY,1968,5,0,5,1,0
1972_GUY,GUY,1972,3,0,3,1,0
1980_GUY,GUY,1980,7,1,8,0.875,0.125
1984_GUY,GUY,1984,8,2,10,0.8,0.2
1988_GUY,GUY,1988,7,1,8,0.875,0.125
1992_GUY,GUY,1992,5,1,6,0.833,0.167
1996_GUY,GUY,1996,6,1,7,0.857,0.143
2000_GUY,GUY,2000,3,1,4,0.75,0.25
2004_GUY,GUY,2004,2,2,4,0.5,0.5
2008_GUY,GUY,2008,2,2,4,0.5,0.5
2012_GUY,GUY,2012,4,2,6,0.667,0.333
2016_GUY,GUY,2016,3,3,6,0.5,0.5
1900_HAI,HAI,1900,3,0,3,1,0
1924_HAI,HAI,1924,8,0,8,1,0
1928_HAI,HAI,1928,2,0,2,1,0
1932_HAI,HAI,1932,3,0,3,1,0
1960_HAI,HAI,1960,1,0,1,1,0
1972_HAI,HAI,1972,6,1,7,0.857,0.143
1976_HAI,HAI,1976,10,3,13,0.769,0.231
1984_HAI,HAI,1984,1,2,3,0.333,0.667
1988_HAI,HAI,1988,3,1,4,0.75,0.25
1992_HAI,HAI,1992,7,0,7,1,0
1996_HAI,HAI,1996,7,0,7,1,0
2000_HAI,HAI,2000,3,2,5,0.6,0.4
2004_HAI,HAI,2004,7,1,8,0.875,0.125
2008_HAI,HAI,2008,3,4,7,0.429,0.571
2012_HAI,HAI,2012,3,2,5,0.6,0.4
2016_HAI,HAI,2016,7,3,10,0.7,0.3
1952_HKG,HKG,1952,2,2,4,0.5,0.5
1956_HKG,HKG,1956,2,0,2,1,0
1960_HKG,HKG,1960,4,0,4,1,0
1964_HKG,HKG,1964,38,1,39,0.974,0.026
1968_HKG,HKG,1968,11,0,11,1,0
1972_HKG,HKG,1972,10,0,10,1,0
1976_HKG,HKG,1976,23,2,25,0.92,0.08
1984_HKG,HKG,1984,36,11,47,0.766,0.234
1988_HKG,HKG,1988,38,10,48,0.792,0.208
1992_HKG,HKG,1992,28,10,38,0.737,0.263
1996_HKG,HKG,1996,14,9,23,0.609,0.391
2000_HKG,HKG,2000,19,12,31,0.613,0.387
2004_HKG,HKG,2004,14,18,32,0.438,0.563
2008_HKG,HKG,2008,17,17,34,0.5,0.5
2012_HKG,HKG,2012,21,20,41,0.512,0.488
2016_HKG,HKG,2016,15,22,37,0.405,0.595
1968_HON,HON,1968,6,0,6,1,0
1976_HON,HON,1976,3,0,3,1,0
1984_HON,HON,1984,7,3,10,0.7,0.3
1988_HON,HON,1988,7,1,8,0.875,0.125
1992_HON,HON,1992,7,4,11,0.636,0.364
1996_HON,HON,1996,4,3,7,0.571,0.429
2000_HON,HON,2000,18,2,20,0.9,0.1
2004_HON,HON,2004,3,2,5,0.6,0.4
2008_HON,HON,2008,23,2,25,0.92,0.08
2012_HON,HON,2012,22,3,25,0.88,0.12
2016_HON,HON,2016,22,1,23,0.957,0.043
1896_HUN,HUN,1896,7,0,7,1,0
1900_HUN,HUN,1900,18,0,18,1,0
1904_HUN,HUN,1904,4,0,4,1,0
1908_HUN,HUN,1908,65,0,65,1,0
1912_HUN,HUN,1912,121,0,121,1,0
1924_HUN,HUN,1924,90,3,93,0.968,0.032
1928_HUN,HUN,1928,105,16,121,0.868,0.132
1932_HUN,HUN,1932,58,4,62,0.935,0.065
1936_HUN,HUN,1936,216,22,238,0.908,0.092
1948_HUN,HUN,1948,124,26,150,0.827,0.173
1952_HUN,HUN,1952,170,31,201,0.846,0.154
1956_HUN,HUN,1956,92,21,113,0.814,0.186
1960_HUN,HUN,1960,159,28,187,0.85,0.15
1964_HUN,HUN,1964,172,38,210,0.819,0.181
1968_HUN,HUN,1968,143,34,177,0.808,0.192
1972_HUN,HUN,1972,187,46,233,0.803,0.197
1976_HUN,HUN,1976,126,55,181,0.696,0.304
1980_HUN,HUN,1980,183,82,265,0.691,0.309
1984_HUN,HUN,1984,7,2,9,0.778,0.222
1988_HUN,HUN,1988,155,38,193,0.803,0.197
1992_HUN,HUN,1992,172,69,241,0.714,0.286
1996_HUN,HUN,1996,147,66,213,0.69,0.31
2000_HUN,HUN,2000,109,69,178,0.612,0.388
2004_HUN,HUN,2004,119,90,209,0.569,0.431
2008_HUN,HUN,2008,88,83,171,0.515,0.485
2012_HUN,HUN,2012,93,59,152,0.612,0.388
2016_HUN,HUN,2016,88,66,154,0.571,0.429
1952_INA,INA,1952,3,0,3,1,0
1956_INA,INA,1956,20,2,22,0.909,0.091
1960_INA,INA,1960,20,2,22,0.909,0.091
1968_INA,INA,1968,6,0,6,1,0
1972_INA,INA,1972,3,3,6,0.5,0.5
1976_INA,INA,1976,5,2,7,0.714,0.286
1984_INA,INA,1984,13,3,16,0.813,0.188
1988_INA,INA,1988,23,6,29,0.793,0.207
1992_INA,INA,1992,27,15,42,0.643,0.357
1996_INA,INA,1996,23,17,40,0.575,0.425
2000_INA,INA,2000,27,20,47,0.574,0.426
2004_INA,INA,2004,22,16,38,0.579,0.421
2008_INA,INA,2008,15,9,24,0.625,0.375
2012_INA,INA,2012,13,9,22,0.591,0.409
2016_INA,INA,2016,17,11,28,0.607,0.393
1900_IND,IND,1900,1,0,1,1,0
1920_IND,IND,1920,5,0,5,1,0
1924_IND,IND,1924,19,1,20,0.95,0.05
1928_IND,IND,1928,21,0,21,1,0
1932_IND,IND,1932,19,0,19,1,0
1936_IND,IND,1936,27,0,27,1,0
1948_IND,IND,1948,79,0,79,1,0
1952_IND,IND,1952,60,4,64,0.938,0.063
1956_IND,IND,1956,58,1,59,0.983,0.017
1960_IND,IND,1960,45,0,45,1,0
1964_IND,IND,1964,53,1,54,0.981,0.019
1968_IND,IND,1968,26,0,26,1,0
1972_IND,IND,1972,40,1,41,0.976,0.024
1976_IND,IND,1976,26,0,26,1,0
1980_IND,IND,1980,56,16,72,0.778,0.222
1984_IND,IND,1984,42,6,48,0.875,0.125
1988_IND,IND,1988,41,8,49,0.837,0.163
1992_IND,IND,1992,48,6,54,0.889,0.111
1996_IND,IND,1996,40,9,49,0.816,0.184
2000_IND,IND,2000,44,21,65,0.677,0.323
2004_IND,IND,2004,48,25,73,0.658,0.342
2008_IND,IND,2008,31,22,53,0.585,0.415
2012_IND,IND,2012,58,23,81,0.716,0.284
2016_IND,IND,2016,61,51,112,0.545,0.455
1992_IOA,IOA,1992,39,19,58,0.672,0.328
2000_IOA,IOA,2000,3,1,4,0.75,0.25
2012_IOA,IOA,2012,3,1,4,0.75,0.25
2016_IOA,IOA,2016,8,1,9,0.889,0.111
1900_IRI,IRI,1900,1,0,1,1,0
1948_IRI,IRI,1948,36,0,36,1,0
1952_IRI,IRI,1952,22,0,22,1,0
1956_IRI,IRI,1956,20,0,20,1,0
1960_IRI,IRI,1960,23,0,23,1,0
1964_IRI,IRI,1964,62,4,66,0.939,0.061
1968_IRI,IRI,1968,18,0,18,1,0
1972_IRI,IRI,1972,52,0,52,1,0
1976_IRI,IRI,1976,84,4,88,0.955,0.045
1988_IRI,IRI,1988,23,0,23,1,0
1992_IRI,IRI,1992,36,0,36,1,0
1996_IRI,IRI,1996,17,1,18,0.944,0.056
2000_IRI,IRI,2000,32,1,33,0.97,0.03
2004_IRI,IRI,2004,36,1,37,0.973,0.027
2008_IRI,IRI,2008,51,3,54,0.944,0.056
2012_IRI,IRI,2012,44,8,52,0.846,0.154
2016_IRI,IRI,2016,54,9,63,0.857,0.143
1924_IRL,IRL,1924,46,2,48,0.958,0.042
1928_IRL,IRL,1928,33,5,38,0.868,0.132
1932_IRL,IRL,1932,14,2,16,0.875,0.125
1948_IRL,IRL,1948,68,5,73,0.932,0.068
1952_IRL,IRL,1952,19,0,19,1,0
1956_IRL,IRL,1956,17,1,18,0.944,0.056
1960_IRL,IRL,1960,47,2,49,0.959,0.041
1964_IRL,IRL,1964,24,1,25,0.96,0.04
1968_IRL,IRL,1968,25,6,31,0.806,0.194
1972_IRL,IRL,1972,51,8,59,0.864,0.136
1976_IRL,IRL,1976,41,3,44,0.932,0.068
1980_IRL,IRL,1980,44,3,47,0.936,0.064
1984_IRL,IRL,1984,28,14,42,0.667,0.333
1988_IRL,IRL,1988,52,9,61,0.852,0.148
1992_IRL,IRL,1992,52,9,61,0.852,0.148
1996_IRL,IRL,1996,62,16,78,0.795,0.205
2000_IRL,IRL,2000,40,24,64,0.625,0.375
2004_IRL,IRL,2004,32,14,46,0.696,0.304
2008_IRL,IRL,2008,39,16,55,0.709,0.291
2012_IRL,IRL,2012,36,28,64,0.563,0.438
2016_IRL,IRL,2016,50,26,76,0.658,0.342
1948_IRQ,IRQ,1948,11,0,11,1,0
1960_IRQ,IRQ,1960,21,0,21,1,0
1964_IRQ,IRQ,1964,13,0,13,1,0
1968_IRQ,IRQ,1968,3,0,3,1,0
1980_IRQ,IRQ,1980,43,0,43,1,0
1984_IRQ,IRQ,1984,23,0,23,1,0
1988_IRQ,IRQ,1988,27,0,27,1,0
1992_IRQ,IRQ,1992,8,0,8,1,0
1996_IRQ,IRQ,1996,3,0,3,1,0
2000_IRQ,IRQ,2000,2,2,4,0.5,0.5
2004_IRQ,IRQ,2004,23,1,24,0.958,0.042
2008_IRQ,IRQ,2008,3,1,4,0.75,0.25
2012_IRQ,IRQ,2012,5,3,8,0.625,0.375
2016_IRQ,IRQ,2016,20,0,20,1,0
1908_ISL,ISL,1908,1,0,1,1,0
1912_ISL,ISL,1912,2,0,2,1,0
1936_ISL,ISL,1936,12,0,12,1,0
1948_ISL,ISL,1948,21,3,24,0.875,0.125
1952_ISL,ISL,1952,20,0,20,1,0
1956_ISL,ISL,1956,8,1,9,0.889,0.111
1960_ISL,ISL,1960,12,1,13,0.923,0.077
1964_ISL,ISL,1964,8,1,9,0.889,0.111
1968_ISL,ISL,1968,10,2,12,0.833,0.167
1972_ISL,ISL,1972,24,1,25,0.96,0.04
1976_ISL,ISL,1976,15,6,21,0.714,0.286
1980_ISL,ISL,1980,14,1,15,0.933,0.067
1984_ISL,ISL,1984,31,4,35,0.886,0.114
1988_ISL,ISL,1988,30,5,35,0.857,0.143
1992_ISL,ISL,1992,28,4,32,0.875,0.125
1996_ISL,ISL,1996,5,4,9,0.556,0.444
2000_ISL,ISL,2000,9,9,18,0.5,0.5
2004_ISL,ISL,2004,21,5,26,0.808,0.192
2008_ISL,ISL,2008,20,7,27,0.741,0.259
2012_ISL,ISL,2012,21,6,27,0.778,0.222
2016_ISL,ISL,2016,3,5,8,0.375,0.625
1952_ISR,ISR,1952,22,3,25,0.88,0.12
1956_ISR,ISR,1956,2,1,3,0.667,0.333
1960_ISR,ISR,1960,17,6,23,0.739,0.261
1964_ISR,ISR,1964,8,2,10,0.8,0.2
1968_ISR,ISR,1968,26,3,29,0.897,0.103
1972_ISR,ISR,1972,12,2,14,0.857,0.143
1976_ISR,ISR,1976,24,2,26,0.923,0.077
1984_ISR,ISR,1984,24,8,32,0.75,0.25
1988_ISR,ISR,1988,14,4,18,0.778,0.222
1992_ISR,ISR,1992,25,5,30,0.833,0.167
1996_ISR,ISR,1996,18,7,25,0.72,0.28
2000_ISR,ISR,2000,29,10,39,0.744,0.256
2004_ISR,ISR,2004,20,16,36,0.556,0.444
2008_ISR,ISR,2008,23,20,43,0.535,0.465
2012_ISR,ISR,2012,19,18,37,0.514,0.486
2016_ISR,ISR,2016,22,25,47,0.468,0.532
1968_ISV,ISV,1968,6,0,6,1,0
1972_ISV,ISV,1972,16,0,16,1,0
1976_ISV,ISV,1976,19,2,21,0.905,0.095
1984_ISV,ISV,1984,26,3,29,0.897,0.103
1988_ISV,ISV,1988,22,5,27,0.815,0.185
1992_ISV,ISV,1992,30,7,37,0.811,0.189
1996_ISV,ISV,1996,6,6,12,0.5,0.5
2000_ISV,ISV,2000,6,3,9,0.667,0.333
2004_ISV,ISV,2004,5,1,6,0.833,0.167
2008_ISV,ISV,2008,6,1,7,0.857,0.143
2012_ISV,ISV,2012,4,3,7,0.571,0.429
2016_ISV,ISV,2016,5,2,7,0.714,0.286
1896_ITA,ITA,1896,1,0,1,1,0
1900_ITA,ITA,1900,22,1,23,0.957,0.043
1904_ITA,ITA,1904,1,0,1,1,0
1908_ITA,ITA,1908,66,0,66,1,0
1912_ITA,ITA,1912,66,0,66,1,0
1920_ITA,ITA,1920,173,1,174,0.994,0.006
1924_ITA,ITA,1924,219,4,223,0.982,0.018
1928_ITA,ITA,1928,169,18,187,0.904,0.096
1932_ITA,ITA,1932,124,0,124,1,0
1936_ITA,ITA,1936,263,21,284,0.926,0.074
1948_ITA,ITA,1948,245,24,269,0.911,0.089
1952_ITA,ITA,1952,236,28,264,0.894,0.106
1956_ITA,ITA,1956,173,27,200,0.865,0.135
1960_ITA,ITA,1960,267,41,308,0.867,0.133
1964_ITA,ITA,1964,210,19,229,0.917,0.083
1968_ITA,ITA,1968,191,23,214,0.893,0.107
1972_ITA,ITA,1972,238,30,268,0.888,0.112
1976_ITA,ITA,1976,230,38,268,0.858,0.142
1980_ITA,ITA,1980,155,50,205,0.756,0.244
1984_ITA,ITA,1984,281,61,342,0.822,0.178
1988_ITA,ITA,1988,254,57,311,0.817,0.183
1992_ITA,ITA,1992,307,104,411,0.747,0.253
1996_ITA,ITA,1996,236,104,340,0.694,0.306
2000_ITA,ITA,2000,246,115,361,0.681,0.319
2004_ITA,ITA,2004,229,135,364,0.629,0.371
2008_ITA,ITA,2008,203,130,333,0.61,0.39
2012_ITA,ITA,2012,158,123,281,0.562,0.438
2016_ITA,ITA,2016,168,141,309,0.544,0.456
1984_IVB,IVB,1984,10,0,10,1,0
1988_IVB,IVB,1988,3,0,3,1,0
1992_IVB,IVB,1992,4,0,4,1,0
1996_IVB,IVB,1996,7,0,7,1,0
2000_IVB,IVB,2000,1,0,1,1,0
2004_IVB,IVB,2004,1,0,1,1,0
2008_IVB,IVB,2008,1,1,2,0.5,0.5
2012_IVB,IVB,2012,1,1,2,0.5,0.5
2016_IVB,IVB,2016,1,3,4,0.25,0.75
1948_JAM,JAM,1948,9,4,13,0.692,0.308
1952_JAM,JAM,1952,6,2,8,0.75,0.25
1956_JAM,JAM,1956,6,0,6,1,0
1964_JAM,JAM,1964,17,4,21,0.81,0.19
1968_JAM,JAM,1968,20,5,25,0.8,0.2
1972_JAM,JAM,1972,21,12,33,0.636,0.364
1976_JAM,JAM,1976,11,9,20,0.55,0.45
1980_JAM,JAM,1980,11,7,18,0.611,0.389
1984_JAM,JAM,1984,31,14,45,0.689,0.311
1988_JAM,JAM,1988,28,11,39,0.718,0.282
1992_JAM,JAM,1992,27,14,41,0.659,0.341
1996_JAM,JAM,1996,27,19,46,0.587,0.413
2000_JAM,JAM,2000,22,26,48,0.458,0.542
2004_JAM,JAM,2004,22,25,47,0.468,0.532
2008_JAM,JAM,2008,23,27,50,0.46,0.54
2012_JAM,JAM,2012,23,22,45,0.511,0.489
2016_JAM,JAM,2016,25,31,56,0.446,0.554
1980_JOR,JOR,1980,4,0,4,1,0
1984_JOR,JOR,1984,12,1,13,0.923,0.077
1988_JOR,JOR,1988,5,2,7,0.714,0.286
1992_JOR,JOR,1992,3,1,4,0.75,0.25
1996_JOR,JOR,1996,3,2,5,0.6,0.4
2000_JOR,JOR,2000,4,4,8,0.5,0.5
2004_JOR,JOR,2004,4,4,8,0.5,0.5
2008_JOR,JOR,2008,3,4,7,0.429,0.571
2012_JOR,JOR,2012,5,4,9,0.556,0.444
2016_JOR,JOR,2016,7,1,8,0.875,0.125
1912_JPN,JPN,1912,2,0,2,1,0
1920_JPN,JPN,1920,15,0,15,1,0
1924_JPN,JPN,1924,19,0,19,1,0
1928_JPN,JPN,1928,45,1,46,0.978,0.022
1932_JPN,JPN,1932,155,18,173,0.896,0.104
1936_JPN,JPN,1936,231,20,251,0.92,0.08
1952_JPN,JPN,1952,71,11,82,0.866,0.134
1956_JPN,JPN,1956,106,16,122,0.869,0.131
1960_JPN,JPN,1960,178,25,203,0.877,0.123
1964_JPN,JPN,1964,311,64,375,0.829,0.171
1968_JPN,JPN,1968,198,34,232,0.853,0.147
1972_JPN,JPN,1972,213,56,269,0.792,0.208
1976_JPN,JPN,1976,203,68,271,0.749,0.251
1980_JPN,JPN,1980,46,4,50,0.92,0.08
1984_JPN,JPN,1984,206,59,265,0.777,0.223
1988_JPN,JPN,1988,223,78,301,0.741,0.259
1992_JPN,JPN,1992,215,100,315,0.683,0.317
1996_JPN,JPN,1996,157,149,306,0.513,0.487
2000_JPN,JPN,2000,156,110,266,0.586,0.414
2004_JPN,JPN,2004,139,167,306,0.454,0.546
2008_JPN,JPN,2008,167,165,332,0.503,0.497
2012_JPN,JPN,2012,136,155,291,0.467,0.533
2016_JPN,JPN,2016,171,164,335,0.51,0.49
1996_KAZ,KAZ,1996,72,24,96,0.75,0.25
2000_KAZ,KAZ,2000,86,44,130,0.662,0.338
2004_KAZ,KAZ,2004,71,43,114,0.623,0.377
2008_KAZ,KAZ,2008,60,70,130,0.462,0.538
2012_KAZ,KAZ,2012,73,40,113,0.646,0.354
2016_KAZ,KAZ,2016,55,46,101,0.545,0.455
1956_KEN,KEN,1956,24,1,25,0.96,0.04
1960_KEN,KEN,1960,27,0,27,1,0
1964_KEN,KEN,1964,37,0,37,1,0
1968_KEN,KEN,1968,36,3,39,0.923,0.077
1972_KEN,KEN,1972,55,2,57,0.965,0.035
1984_KEN,KEN,1984,56,5,61,0.918,0.082
1988_KEN,KEN,1988,70,4,74,0.946,0.054
1992_KEN,KEN,1992,40,9,49,0.816,0.184
1996_KEN,KEN,1996,42,10,52,0.808,0.192
2000_KEN,KEN,2000,34,22,56,0.607,0.393
2004_KEN,KEN,2004,22,24,46,0.478,0.522
2008_KEN,KEN,2008,28,18,46,0.609,0.391
2012_KEN,KEN,2012,27,20,47,0.574,0.426
2016_KEN,KEN,2016,46,33,79,0.582,0.418
1996_KGZ,KGZ,1996,26,7,33,0.788,0.212
2000_KGZ,KGZ,2000,35,13,48,0.729,0.271
2004_KGZ,KGZ,2004,22,7,29,0.759,0.241
2008_KGZ,KGZ,2008,16,4,20,0.8,0.2
2012_KGZ,KGZ,2012,11,3,14,0.786,0.214
2016_KGZ,KGZ,2016,12,7,19,0.632,0.368
2004_KIR,KIR,2004,2,1,3,0.667,0.333
2008_KIR,KIR,2008,2,0,2,1,0
2012_KIR,KIR,2012,2,1,3,0.667,0.333
2016_KIR,KIR,2016,2,1,3,0.667,0.333
1948_KOR,KOR,1948,48,1,49,0.98,0.02
1952_KOR,KOR,1952,18,1,19,0.947,0.053
1956_KOR,KOR,1956,39,0,39,1,0
1960_KOR,KOR,1960,38,4,42,0.905,0.095
1964_KOR,KOR,1964,133,28,161,0.826,0.174
1968_KOR,KOR,1968,46,16,62,0.742,0.258
1972_KOR,KOR,1972,33,14,47,0.702,0.298
1976_KOR,KOR,1976,39,14,53,0.736,0.264
1980_KOR,KOR,1980,6,4,10,0.6,0.4
1984_KOR,KOR,1984,127,63,190,0.668,0.332
1988_KOR,KOR,1988,287,136,423,0.678,0.322
1992_KOR,KOR,1992,173,76,249,0.695,0.305
1996_KOR,KOR,1996,190,113,303,0.627,0.373
2000_KOR,KOR,2000,175,106,281,0.623,0.377
2004_KOR,KOR,2004,145,119,264,0.549,0.451
2008_KOR,KOR,2008,159,106,265,0.6,0.4
2012_KOR,KOR,2012,135,115,250,0.54,0.46
2016_KOR,KOR,2016,103,104,207,0.498,0.502
2016_KOS,KOS,2016,3,5,8,0.375,0.625
1972_KSA,KSA,1972,10,0,10,1,0
1976_KSA,KSA,1976,14,0,14,1,0
1984_KSA,KSA,1984,37,0,37,1,0
1988_KSA,KSA,1988,9,0,9,1,0
1992_KSA,KSA,1992,9,0,9,1,0
1996_KSA,KSA,1996,29,0,29,1,0
2000_KSA,KSA,2000,18,0,18,1,0
2004_KSA,KSA,2004,16,0,16,1,0
2008_KSA,KSA,2008,14,0,14,1,0
2012_KSA,KSA,2012,16,2,18,0.889,0.111
2016_KSA,KSA,2016,7,3,10,0.7,0.3
1968_KUW,KUW,1968,2,0,2,1,0
1972_KUW,KUW,1972,4,0,4,1,0
1976_KUW,KUW,1976,15,0,15,1,0
1980_KUW,KUW,1980,56,0,56,1,0
1984_KUW,KUW,1984,23,0,23,1,0
1988_KUW,KUW,1988,25,0,25,1,0
1992_KUW,KUW,1992,32,0,32,1,0
1996_KUW,KUW,1996,25,0,25,1,0
2000_KUW,KUW,2000,29,0,29,1,0
2004_KUW,KUW,2004,10,1,11,0.909,0.091
2008_KUW,KUW,2008,8,0,8,1,0
2012_KUW,KUW,2012,8,2,10,0.8,0.2
1980_LAO,LAO,1980,17,2,19,0.895,0.105
1988_LAO,LAO,1988,2,1,3,0.667,0.333
1992_LAO,LAO,1992,6,0,6,1,0
1996_LAO,LAO,1996,4,1,5,0.8,0.2
2000_LAO,LAO,2000,2,1,3,0.667,0.333
2004_LAO,LAO,2004,3,2,5,0.6,0.4
2008_LAO,LAO,2008,2,2,4,0.5,0.5
2012_LAO,LAO,2012,2,1,3,0.667,0.333
2016_LAO,LAO,2016,3,2,5,0.6,0.4
1924_LAT,LAT,1924,37,0,37,1,0
1928_LAT,LAT,1928,16,2,18,0.889,0.111
1932_LAT,LAT,1932,5,0,5,1,0
1936_LAT,LAT,1936,52,3,55,0.945,0.055
1992_LAT,LAT,1992,44,13,57,0.772,0.228
1996_LAT,LAT,1996,34,13,47,0.723,0.277
2000_LAT,LAT,2000,30,15,45,0.667,0.333
2004_LAT,LAT,2004,22,10,32,0.688,0.313
2008_LAT,LAT,2008,29,18,47,0.617,0.383
2012_LAT,LAT,2012,31,14,45,0.689,0.311
2016_LAT,LAT,2016,19,13,32,0.594,0.406
1968_LBA,LBA,1968,1,0,1,1,0
1980_LBA,LBA,1980,27,2,29,0.931,0.069
1988_LBA,LBA,1988,6,0,6,1,0
1992_LBA,LBA,1992,5,0,5,1,0
1996_LBA,LBA,1996,5,0,5,1,0
2000_LBA,LBA,2000,3,0,3,1,0
2004_LBA,LBA,2004,6,2,8,0.75,0.25
2008_LBA,LBA,2008,4,2,6,0.667,0.333
2012_LBA,LBA,2012,3,1,4,0.75,0.25
2016_LBA,LBA,2016,6,1,7,0.857,0.143
1956_LBR,LBR,1956,4,0,4,1,0
1960_LBR,LBR,1960,4,0,4,1,0
1964_LBR,LBR,1964,1,0,1,1,0
1972_LBR,LBR,1972,5,0,5,1,0
1984_LBR,LBR,1984,6,1,7,0.857,0.143
1988_LBR,LBR,1988,7,1,8,0.875,0.125
1996_LBR,LBR,1996,4,1,5,0.8,0.2
2000_LBR,LBR,2000,6,2,8,0.75,0.25
2004_LBR,LBR,2004,1,1,2,0.5,0.5
2008_LBR,LBR,2008,2,1,3,0.667,0.333
2012_LBR,LBR,2012,1,2,3,0.333,0.667
2016_LBR,LBR,2016,1,1,2,0.5,0.5
1996_LCA,LCA,1996,5,1,6,0.833,0.167
2000_LCA,LCA,2000,3,2,5,0.6,0.4
2004_LCA,LCA,2004,1,1,2,0.5,0.5
2008_LCA,LCA,2008,1,3,4,0.25,0.75
2012_LCA,LCA,2012,1,3,4,0.25,0.75
2016_LCA,LCA,2016,2,3,5,0.4,0.6
1972_LES,LES,1972,1,0,1,1,0
1980_LES,LES,1980,5,0,5,1,0
1984_LES,LES,1984,4,0,4,1,0
1988_LES,LES,1988,6,0,6,1,0
1992_LES,LES,1992,5,1,6,0.833,0.167
1996_LES,LES,1996,5,4,9,0.556,0.444
2000_LES,LES,2000,4,2,6,0.667,0.333
2004_LES,LES,2004,1,2,3,0.333,0.667
2008_LES,LES,2008,4,1,5,0.8,0.2
2012_LES,LES,2012,2,2,4,0.5,0.5
2016_LES,LES,2016,7,1,8,0.875,0.125
1948_LIB,LIB,1948,10,0,10,1,0
1952_LIB,LIB,1952,10,0,10,1,0
1956_LIB,LIB,1956,3,0,3,1,0
1960_LIB,LIB,1960,21,0,21,1,0
1964_LIB,LIB,1964,9,0,9,1,0
1968_LIB,LIB,1968,14,0,14,1,0
1972_LIB,LIB,1972,18,2,20,0.9,0.1
1976_LIB,LIB,1976,3,1,4,0.75,0.25
1980_LIB,LIB,1980,17,1,18,0.944,0.056
1984_LIB,LIB,1984,25,1,26,0.962,0.038
1988_LIB,LIB,1988,23,2,25,0.92,0.08
1992_LIB,LIB,1992,16,0,16,1,0
1996_LIB,LIB,1996,0,1,1,0,1
2000_LIB,LIB,2000,4,2,6,0.667,0.333
2004_LIB,LIB,2004,3,2,5,0.6,0.4
2008_LIB,LIB,2008,4,2,6,0.667,0.333
2012_LIB,LIB,2012,3,7,10,0.3,0.7
2016_LIB,LIB,2016,4,5,9,0.444,0.556
1936_LIE,LIE,1936,10,0,10,1,0
1948_LIE,LIE,1948,12,0,12,1,0
1952_LIE,LIE,1952,2,0,2,1,0
1956_LIE,LIE,1956,8,0,8,1,0
1960_LIE,LIE,1960,8,0,8,1,0
1964_LIE,LIE,1964,8,0,8,1,0
1968_LIE,LIE,1968,10,1,11,0.909,0.091
1972_LIE,LIE,1972,9,1,10,0.9,0.1
1976_LIE,LIE,1976,10,5,15,0.667,0.333
1980_LIE,LIE,1980,4,3,7,0.571,0.429
1984_LIE,LIE,1984,12,5,17,0.706,0.294
1988_LIE,LIE,1988,20,5,25,0.8,0.2
1992_LIE,LIE,1992,10,4,14,0.714,0.286
1996_LIE,LIE,1996,0,2,2,0,1
2000_LIE,LIE,2000,1,1,2,0.5,0.5
2004_LIE,LIE,2004,1,0,1,1,0
2008_LIE,LIE,2008,2,0,2,1,0
2012_LIE,LIE,2012,1,2,3,0.333,0.667
2016_LIE,LIE,2016,1,2,3,0.333,0.667
1924_LTU,LTU,1924,13,0,13,1,0
1928_LTU,LTU,1928,12,1,13,0.923,0.077
1992_LTU,LTU,1992,39,14,53,0.736,0.264
1996_LTU,LTU,1996,45,16,61,0.738,0.262
2000_LTU,LTU,2000,40,21,61,0.656,0.344
2004_LTU,LTU,2004,47,12,59,0.797,0.203
2008_LTU,LTU,2008,44,27,71,0.62,0.38
2012_LTU,LTU,2012,39,23,62,0.629,0.371
2016_LTU,LTU,2016,48,19,67,0.716,0.284
1900_LUX,LUX,1900,1,0,1,1,0
1912_LUX,LUX,1912,21,0,21,1,0
1920_LUX,LUX,1920,25,0,25,1,0
1924_LUX,LUX,1924,46,2,48,0.958,0.042
1928_LUX,LUX,1928,51,2,53,0.962,0.038
1932_LUX,LUX,1932,3,0,3,1,0
1936_LUX,LUX,1936,52,1,53,0.981,0.019
1948_LUX,LUX,1948,42,3,45,0.933,0.067
1952_LUX,LUX,1952,44,0,44,1,0
1956_LUX,LUX,1956,10,1,11,0.909,0.091
1960_LUX,LUX,1960,47,5,52,0.904,0.096
1964_LUX,LUX,1964,10,2,12,0.833,0.167
1968_LUX,LUX,1968,3,2,5,0.6,0.4
1972_LUX,LUX,1972,10,1,11,0.909,0.091
1976_LUX,LUX,1976,8,0,8,1,0
1980_LUX,LUX,1980,3,0,3,1,0
1984_LUX,LUX,1984,4,1,5,0.8,0.2
1988_LUX,LUX,1988,6,3,9,0.667,0.333
1992_LUX,LUX,1992,6,1,7,0.857,0.143
1996_LUX,LUX,1996,2,4,6,0.333,0.667
2000_LUX,LUX,2000,2,5,7,0.286,0.714
2004_LUX,LUX,2004,6,4,10,0.6,0.4
2008_LUX,LUX,2008,9,4,13,0.692,0.308
2012_LUX,LUX,2012,5,4,9,0.556,0.444
2016_LUX,LUX,2016,5,5,10,0.5,0.5
1964_MAD,MAD,1964,3,0,3,1,0
1968_MAD,MAD,1968,4,0,4,1,0
1972_MAD,MAD,1972,11,0,11,1,0
1980_MAD,MAD,1980,8,3,11,0.727,0.273
1984_MAD,MAD,1984,5,0,5,1,0
1992_MAD,MAD,1992,8,5,13,0.615,0.385
1996_MAD,MAD,1996,4,7,11,0.364,0.636
2000_MAD,MAD,2000,5,6,11,0.455,0.545
2004_MAD,MAD,2004,3,5,8,0.375,0.625
2008_MAD,MAD,2008,4,2,6,0.667,0.333
2012_MAD,MAD,2012,3,4,7,0.429,0.571
2016_MAD,MAD,2016,2,4,6,0.333,0.667
1956_MAL,MAL,1956,31,1,32,0.969,0.031
1960_MAL,MAL,1960,9,0,9,1,0
1960_MAR,MAR,1960,47,0,47,1,0
1964_MAR,MAR,1964,20,0,20,1,0
1968_MAR,MAR,1968,30,0,30,1,0
1972_MAR,MAR,1972,33,2,35,0.943,0.057
1976_MAR,MAR,1976,9,0,9,1,0
1984_MAR,MAR,1984,37,1,38,0.974,0.026
1988_MAR,MAR,1988,27,3,30,0.9,0.1
1992_MAR,MAR,1992,53,3,56,0.946,0.054
1996_MAR,MAR,1996,32,2,34,0.941,0.059
2000_MAR,MAR,2000,46,9,55,0.836,0.164
2004_MAR,MAR,2004,47,8,55,0.855,0.145
2008_MAR,MAR,2008,36,11,47,0.766,0.234
2012_MAR,MAR,2012,46,17,63,0.73,0.27
2016_MAR,MAR,2016,29,19,48,0.604,0.396
1964_MAS,MAS,1964,57,4,61,0.934,0.066
1968_MAS,MAS,1968,31,0,31,1,0
1972_MAS,MAS,1972,42,3,45,0.933,0.067
1976_MAS,MAS,1976,23,0,23,1,0
1984_MAS,MAS,1984,20,1,21,0.952,0.048
1988_MAS,MAS,1988,5,4,9,0.556,0.444
1992_MAS,MAS,1992,26,0,26,1,0
1996_MAS,MAS,1996,32,3,35,0.914,0.086
2000_MAS,MAS,2000,32,8,40,0.8,0.2
2004_MAS,MAS,2004,18,8,26,0.692,0.308
2008_MAS,MAS,2008,18,14,32,0.563,0.438
2012_MAS,MAS,2012,16,13,29,0.552,0.448
2016_MAS,MAS,2016,17,15,32,0.531,0.469
1972_MAW,MAW,1972,13,3,16,0.813,0.188
1984_MAW,MAW,1984,15,0,15,1,0
1988_MAW,MAW,1988,16,0,16,1,0
1992_MAW,MAW,1992,3,1,4,0.75,0.25
1996_MAW,MAW,1996,2,0,2,1,0
2000_MAW,MAW,2000,1,1,2,0.5,0.5
2004_MAW,MAW,2004,2,2,4,0.5,0.5
2008_MAW,MAW,2008,2,2,4,0.5,0.5
2012_MAW,MAW,2012,1,2,3,0.333,0.667
2016_MAW,MAW,2016,3,2,5,0.6,0.4
1996_MDA,MDA,1996,35,5,40,0.875,0.125
2000_MDA,MDA,2000,29,5,34,0.853,0.147
2004_MDA,MDA,2004,26,7,33,0.788,0.212
2008_MDA,MDA,2008,21,8,29,0.724,0.276
2012_MDA,MDA,2012,12,8,20,0.6,0.4
2016_MDA,MDA,2016,14,9,23,0.609,0.391
1988_MDV,MDV,1988,7,0,7,1,0
1992_MDV,MDV,1992,6,1,7,0.857,0.143
1996_MDV,MDV,1996,5,1,6,0.833,0.167
2000_MDV,MDV,2000,2,2,4,0.5,0.5
2004_MDV,MDV,2004,2,2,4,0.5,0.5
2008_MDV,MDV,2008,2,2,4,0.5,0.5
2012_MDV,MDV,2012,3,2,5,0.6,0.4
2016_MDV,MDV,2016,2,2,4,0.5,0.5
1900_MEX,MEX,1900,3,0,3,1,0
1924_MEX,MEX,1924,15,0,15,1,0
1928_MEX,MEX,1928,35,0,35,1,0
1932_MEX,MEX,1932,71,2,73,0.973,0.027
1936_MEX,MEX,1936,32,0,32,1,0
1948_MEX,MEX,1948,81,7,88,0.92,0.08
1952_MEX,MEX,1952,61,3,64,0.953,0.047
1956_MEX,MEX,1956,21,3,24,0.875,0.125
1960_MEX,MEX,1960,63,6,69,0.913,0.087
1964_MEX,MEX,1964,90,4,94,0.957,0.043
1968_MEX,MEX,1968,233,42,275,0.847,0.153
1972_MEX,MEX,1972,152,22,174,0.874,0.126
1976_MEX,MEX,1976,92,5,97,0.948,0.052
1980_MEX,MEX,1980,36,9,45,0.8,0.2
1984_MEX,MEX,1984,78,22,100,0.78,0.22
1988_MEX,MEX,1988,76,18,94,0.809,0.191
1992_MEX,MEX,1992,92,30,122,0.754,0.246
1996_MEX,MEX,1996,71,27,98,0.724,0.276
2000_MEX,MEX,2000,52,26,78,0.667,0.333
2004_MEX,MEX,2004,59,50,109,0.541,0.459
2008_MEX,MEX,2008,43,40,83,0.518,0.482
2012_MEX,MEX,2012,62,37,99,0.626,0.374
2016_MEX,MEX,2016,79,44,123,0.642,0.358
1964_MGL,MGL,1964,27,7,34,0.794,0.206
1968_MGL,MGL,1968,19,4,23,0.826,0.174
1972_MGL,MGL,1972,41,2,43,0.953,0.047
1976_MGL,MGL,1976,30,2,32,0.938,0.063
1980_MGL,MGL,1980,42,4,46,0.913,0.087
1984_MGL,MGL,1984,4,0,4,1,0
1988_MGL,MGL,1988,26,5,31,0.839,0.161
1992_MGL,MGL,1992,31,6,37,0.838,0.162
1996_MGL,MGL,1996,12,4,16,0.75,0.25
2000_MGL,MGL,2000,12,8,20,0.6,0.4
2004_MGL,MGL,2004,13,7,20,0.65,0.35
2008_MGL,MGL,2008,14,14,28,0.5,0.5
2012_MGL,MGL,2012,16,13,29,0.552,0.448
2016_MGL,MGL,2016,26,17,43,0.605,0.395
2008_MHL,MHL,2008,3,2,5,0.6,0.4
2012_MHL,MHL,2012,2,2,4,0.5,0.5
2016_MHL,MHL,2016,2,3,5,0.4,0.6
1996_MKD,MKD,1996,8,3,11,0.727,0.273
2000_MKD,MKD,2000,6,4,10,0.6,0.4
2004_MKD,MKD,2004,7,3,10,0.7,0.3
2008_MKD,MKD,2008,5,2,7,0.714,0.286
2012_MKD,MKD,2012,2,2,4,0.5,0.5
2016_MKD,MKD,2016,2,4,6,0.333,0.667
1964_MLI,MLI,1964,2,0,2,1,0
1968_MLI,MLI,1968,2,0,2,1,0
1972_MLI,MLI,1972,3,0,3,1,0
1980_MLI,MLI,1980,6,1,7,0.857,0.143
1984_MLI,MLI,1984,4,0,4,1,0
1988_MLI,MLI,1988,5,1,6,0.833,0.167
1992_MLI,MLI,1992,3,2,5,0.6,0.4
1996_MLI,MLI,1996,1,2,3,0.333,0.667
2000_MLI,MLI,2000,3,2,5,0.6,0.4
2004_MLI,MLI,2004,19,2,21,0.905,0.095
2008_MLI,MLI,2008,3,14,17,0.176,0.824
2012_MLI,MLI,2012,4,2,6,0.667,0.333
2016_MLI,MLI,2016,4,2,6,0.667,0.333
1928_MLT,MLT,1928,9,0,9,1,0
1936_MLT,MLT,1936,11,0,11,1,0
1948_MLT,MLT,1948,1,0,1,1,0
1960_MLT,MLT,1960,10,0,10,1,0
1968_MLT,MLT,1968,1,0,1,1,0
1972_MLT,MLT,1972,5,0,5,1,0
1980_MLT,MLT,1980,7,1,8,0.875,0.125
1984_MLT,MLT,1984,5,2,7,0.714,0.286
1988_MLT,MLT,1988,5,1,6,0.833,0.167
1992_MLT,MLT,1992,3,3,6,0.5,0.5
1996_MLT,MLT,1996,4,3,7,0.571,0.429
2000_MLT,MLT,2000,4,3,7,0.571,0.429
2004_MLT,MLT,2004,4,3,7,0.571,0.429
2008_MLT,MLT,2008,3,3,6,0.5,0.5
2012_MLT,MLT,2012,3,2,5,0.6,0.4
2016_MLT,MLT,2016,4,3,7,0.571,0.429
2008_MNE,MNE,2008,17,2,19,0.895,0.105
2012_MNE,MNE,2012,18,15,33,0.545,0.455
2016_MNE,MNE,2016,17,18,35,0.486,0.514
1920_MON,MON,1920,4,0,4,1,0
1924_MON,MON,1924,7,0,7,1,0
1928_MON,MON,1928,10,0,10,1,0
1932_MON,MON,1932,1,0,1,1,0
1936_MON,MON,1936,8,0,8,1,0
1948_MON,MON,1948,4,0,4,1,0
1952_MON,MON,1952,8,0,8,1,0
1960_MON,MON,1960,11,0,11,1,0
1964_MON,MON,1964,1,0,1,1,0
1968_MON,MON,1968,2,0,2,1,0
1972_MON,MON,1972,5,0,5,1,0
1976_MON,MON,1976,8,0,8,1,0
1984_MON,MON,1984,9,0,9,1,0
1988_MON,MON,1988,10,1,11,0.909,0.091
1992_MON,MON,1992,6,1,7,0.857,0.143
1996_MON,MON,1996,2,1,3,0.667,0.333
2000_MON,MON,2000,3,1,4,0.75,0.25
2004_MON,MON,2004,2,1,3,0.667,0.333
2008_MON,MON,2008,4,1,5,0.8,0.2
2012_MON,MON,2012,5,1,6,0.833,0.167
2016_MON,MON,2016,3,0,3,1,0
1980_MOZ,MOZ,1980,12,2,14,0.857,0.143
1984_MOZ,MOZ,1984,8,1,9,0.889,0.111
1988_MOZ,MOZ,1988,6,2,8,0.75,0.25
1992_MOZ,MOZ,1992,3,3,6,0.5,0.5
1996_MOZ,MOZ,1996,2,1,3,0.667,0.333
2000_MOZ,MOZ,2000,2,2,4,0.5,0.5
2004_MOZ,MOZ,2004,2,2,4,0.5,0.5
2008_MOZ,MOZ,2008,2,2,4,0.5,0.5
2012_MOZ,MOZ,2012,4,2,6,0.667,0.333
2016_MOZ,MOZ,2016,5,1,6,0.833,0.167
1984_MRI,MRI,1984,3,1,4,0.75,0.25
1988_MRI,MRI,1988,6,2,8,0.75,0.25
1992_MRI,MRI,1992,6,7,13,0.462,0.538
1996_MRI,MRI,1996,21,5,26,0.808,0.192
2000_MRI,MRI,2000,16,4,20,0.8,0.2
2004_MRI,MRI,2004,6,3,9,0.667,0.333
2008_MRI,MRI,2008,6,5,11,0.545,0.455
2012_MRI,MRI,2012,4,7,11,0.364,0.636
2016_MRI,MRI,2016,5,6,11,0.455,0.545
1984_MTN,MTN,1984,2,0,2,1,0
1988_MTN,MTN,1988,6,0,6,1,0
1992_MTN,MTN,1992,6,0,6,1,0
1996_MTN,MTN,1996,4,0,4,1,0
2000_MTN,MTN,2000,1,1,2,0.5,0.5
2004_MTN,MTN,2004,1,1,2,0.5,0.5
2008_MTN,MTN,2008,1,1,2,0.5,0.5
2012_MTN,MTN,2012,1,1,2,0.5,0.5
2016_MTN,MTN,2016,1,1,2,0.5,0.5
1948_MYA,MYA,1948,4,0,4,1,0
1952_MYA,MYA,1952,5,0,5,1,0
1956_MYA,MYA,1956,11,0,11,1,0
1960_MYA,MYA,1960,10,0,10,1,0
1964_MYA,MYA,1964,11,0,11,1,0
1968_MYA,MYA,1968,4,0,4,1,0
1972_MYA,MYA,1972,18,0,18,1,0
1980_MYA,MYA,1980,2,0,2,1,0
1984_MYA,MYA,1984,1,0,1,1,0
1988_MYA,MYA,1988,0,2,2,0,1
1992_MYA,MYA,1992,1,3,4,0.25,0.75
1996_MYA,MYA,1996,2,1,3,0.667,0.333
2000_MYA,MYA,2000,1,6,7,0.143,0.857
2004_MYA,MYA,2004,0,2,2,0,1
2008_MYA,MYA,2008,4,2,6,0.667,0.333
2012_MYA,MYA,2012,3,3,6,0.5,0.5
2016_MYA,MYA,2016,4,3,7,0.571,0.429
1992_NAM,NAM,1992,5,1,6,0.833,0.167
1996_NAM,NAM,1996,6,2,8,0.75,0.25
2000_NAM,NAM,2000,9,2,11,0.818,0.182
2004_NAM,NAM,2004,7,1,8,0.875,0.125
2008_NAM,NAM,2008,6,4,10,0.6,0.4
2012_NAM,NAM,2012,5,4,9,0.556,0.444
2016_NAM,NAM,2016,4,6,10,0.4,0.6
1956_NBO,NBO,1956,2,0,2,1,0
1968_NCA,NCA,1968,11,0,11,1,0
1972_NCA,NCA,1972,7,1,8,0.875,0.125
1976_NCA,NCA,1976,15,0,15,1,0
1980_NCA,NCA,1980,3,2,5,0.6,0.4
1984_NCA,NCA,1984,5,0,5,1,0
1992_NCA,NCA,1992,7,1,8,0.875,0.125
1996_NCA,NCA,1996,25,1,26,0.962,0.038
2000_NCA,NCA,2000,4,2,6,0.667,0.333
2004_NCA,NCA,2004,2,3,5,0.4,0.6
2008_NCA,NCA,2008,3,3,6,0.5,0.5
2012_NCA,NCA,2012,3,3,6,0.5,0.5
2016_NCA,NCA,2016,3,2,5,0.6,0.4
1900_NED,NED,1900,35,0,35,1,0
1908_NED,NED,1908,113,0,113,1,0
1912_NED,NED,1912,33,0,33,1,0
1920_NED,NED,1920,129,1,130,0.992,0.008
1924_NED,NED,1924,168,9,177,0.949,0.051
1928_NED,NED,1928,229,44,273,0.839,0.161
1932_NED,NED,1932,31,15,46,0.674,0.326
1936_NED,NED,1936,151,22,173,0.873,0.127
1948_NED,NED,1948,119,34,153,0.778,0.222
1952_NED,NED,1952,87,28,115,0.757,0.243
1956_NED,NED,1956,7,2,9,0.778,0.222
1960_NED,NED,1960,85,32,117,0.726,0.274
1964_NED,NED,1964,109,22,131,0.832,0.168
1968_NED,NED,1968,86,30,116,0.741,0.259
1972_NED,NED,1972,95,35,130,0.731,0.269
1976_NED,NED,1976,75,40,115,0.652,0.348
1980_NED,NED,1980,82,22,104,0.788,0.212
1984_NED,NED,1984,91,58,149,0.611,0.389
1988_NED,NED,1988,99,59,158,0.627,0.373
1992_NED,NED,1992,126,94,220,0.573,0.427
1996_NED,NED,1996,137,102,239,0.573,0.427
2000_NED,NED,2000,147,84,231,0.636,0.364
2004_NED,NED,2004,134,76,210,0.638,0.362
2008_NED,NED,2008,139,98,237,0.586,0.414
2012_NED,NED,2012,94,79,173,0.543,0.457
2016_NED,NED,2016,105,132,237,0.443,0.557
1924_NEP,NEP,1924,1,0,1,1,0
1964_NEP,NEP,1964,6,0,6,1,0
1972_NEP,NEP,1972,2,0,2,1,0
1976_NEP,NEP,1976,1,0,1,1,0
1980_NEP,NEP,1980,10,0,10,1,0
1984_NEP,NEP,1984,10,0,10,1,0
1988_NEP,NEP,1988,13,3,16,0.813,0.188
1992_NEP,NEP,1992,1,1,2,0.5,0.5
1996_NEP,NEP,1996,3,3,6,0.5,0.5
2000_NEP,NEP,2000,2,3,5,0.4,0.6
2004_NEP,NEP,2004,3,3,6,0.5,0.5
2008_NEP,NEP,2008,4,4,8,0.5,0.5
2012_NEP,NEP,2012,2,3,5,0.4,0.6
2016_NEP,NEP,2016,3,4,7,0.429,0.571
1904_NFL,NFL,1904,1,0,1,1,0
1952_NGR,NGR,1952,9,0,9,1,0
1956_NGR,NGR,1956,10,0,10,1,0
1960_NGR,NGR,1960,12,0,12,1,0
1964_NGR,NGR,1964,16,2,18,0.889,0.111
1968_NGR,NGR,1968,31,5,36,0.861,0.139
1972_NGR,NGR,1972,20,5,25,0.8,0.2
1980_NGR,NGR,1980,38,6,44,0.864,0.136
1984_NGR,NGR,1984,30,2,32,0.938,0.063
1988_NGR,NGR,1988,61,8,69,0.884,0.116
1992_NGR,NGR,1992,32,23,55,0.582,0.418
1996_NGR,NGR,1996,49,16,65,0.754,0.246
2000_NGR,NGR,2000,44,39,83,0.53,0.47
2004_NGR,NGR,2004,24,46,70,0.343,0.657
2008_NGR,NGR,2008,37,37,74,0.5,0.5
2012_NGR,NGR,2012,30,19,49,0.612,0.388
2016_NGR,NGR,2016,47,24,71,0.662,0.338
1964_NIG,NIG,1964,1,0,1,1,0
1968_NIG,NIG,1968,2,0,2,1,0
1972_NIG,NIG,1972,4,0,4,1,0
1984_NIG,NIG,1984,4,0,4,1,0
1988_NIG,NIG,1988,6,0,6,1,0
1992_NIG,NIG,1992,3,0,3,1,0
1996_NIG,NIG,1996,2,1,3,0.667,0.333
2000_NIG,NIG,2000,2,2,4,0.5,0.5
2004_NIG,NIG,2004,3,1,4,0.75,0.25
2008_NIG,NIG,2008,2,2,4,0.5,0.5
2012_NIG,NIG,2012,4,2,6,0.667,0.333
2016_NIG,NIG,2016,4,2,6,0.667,0.333
1900_NOR,NOR,1900,7,0,7,1,0
1904_NOR,NOR,1904,3,0,3,1,0
1908_NOR,NOR,1908,69,0,69,1,0
1912_NOR,NOR,1912,188,2,190,0.989,0.011
1920_NOR,NOR,1920,187,6,193,0.969,0.031
1924_NOR,NOR,1924,73,3,76,0.961,0.039
1928_NOR,NOR,1928,73,3,76,0.961,0.039
1932_NOR,NOR,1932,24,2,26,0.923,0.077
1936_NOR,NOR,1936,92,8,100,0.92,0.08
1948_NOR,NOR,1948,122,8,130,0.938,0.062
1952_NOR,NOR,1952,156,17,173,0.902,0.098
1956_NOR,NOR,1956,56,11,67,0.836,0.164
1960_NOR,NOR,1960,64,5,69,0.928,0.072
1964_NOR,NOR,1964,75,9,84,0.893,0.107
1968_NOR,NOR,1968,92,19,111,0.829,0.171
1972_NOR,NOR,1972,157,22,179,0.877,0.123
1976_NOR,NOR,1976,94,13,107,0.879,0.121
1980_NOR,NOR,1980,54,9,63,0.857,0.143
1984_NOR,NOR,1984,134,27,161,0.832,0.168
1988_NOR,NOR,1988,97,35,132,0.735,0.265
1992_NOR,NOR,1992,111,51,162,0.685,0.315
1996_NOR,NOR,1996,42,55,97,0.433,0.567
2000_NOR,NOR,2000,44,49,93,0.473,0.527
2004_NOR,NOR,2004,35,17,52,0.673,0.327
2008_NOR,NOR,2008,30,54,84,0.357,0.643
2012_NOR,NOR,2012,33,28,61,0.541,0.459
2016_NOR,NOR,2016,29,33,62,0.468,0.532
1996_NRU,NRU,1996,3,0,3,1,0
2000_NRU,NRU,2000,1,1,2,0.5,0.5
2004_NRU,NRU,2004,2,1,3,0.667,0.333
2008_NRU,NRU,2008,1,0,1,1,0
2012_NRU,NRU,2012,2,0,2,1,0
2016_NRU,NRU,2016,2,0,2,1,0
1900_NZL,NZL,1900,1,0,1,1,0
1920_NZL,NZL,1920,3,1,4,0.75,0.25
1924_NZL,NZL,1924,3,1,4,0.75,0.25
1928_NZL,NZL,1928,6,3,9,0.667,0.333
1932_NZL,NZL,1932,20,1,21,0.952,0.048
1936_NZL,NZL,1936,7,0,7,1,0
1948_NZL,NZL,1948,6,1,7,0.857,0.143
1952_NZL,NZL,1952,14,3,17,0.824,0.176
1956_NZL,NZL,1956,43,8,51,0.843,0.157
1960_NZL,NZL,1960,35,6,41,0.854,0.146
1964_NZL,NZL,1964,56,8,64,0.875,0.125
1968_NZL,NZL,1968,51,7,58,0.879,0.121
1972_NZL,NZL,1972,84,7,91,0.923,0.077
1976_NZL,NZL,1976,74,11,85,0.871,0.129
1980_NZL,NZL,1980,7,2,9,0.778,0.222
1984_NZL,NZL,1984,102,34,136,0.75,0.25
1988_NZL,NZL,1988,74,17,91,0.813,0.187
1992_NZL,NZL,1992,96,43,139,0.691,0.309
1996_NZL,NZL,1996,66,29,95,0.695,0.305
2000_NZL,NZL,2000,77,70,147,0.524,0.476
2004_NZL,NZL,2004,81,67,148,0.547,0.453
2008_NZL,NZL,2008,96,82,178,0.539,0.461
2012_NZL,NZL,2012,96,82,178,0.539,0.461
2016_NZL,NZL,2016,98,97,195,0.503,0.497
1984_OMA,OMA,1984,16,0,16,1,0
1988_OMA,OMA,1988,8,0,8,1,0
1992_OMA,OMA,1992,5,0,5,1,0
1996_OMA,OMA,1996,4,0,4,1,0
2000_OMA,OMA,2000,6,0,6,1,0
2004_OMA,OMA,2004,2,0,2,1,0
2008_OMA,OMA,2008,3,1,4,0.75,0.25
2012_OMA,OMA,2012,2,1,3,0.667,0.333
2016_OMA,OMA,2016,2,2,4,0.5,0.5
1948_PAK,PAK,1948,35,0,35,1,0
1952_PAK,PAK,1952,38,0,38,1,0
1956_PAK,PAK,1956,55,0,55,1,0
1960_PAK,PAK,1960,44,0,44,1,0
1964_PAK,PAK,1964,41,0,41,1,0
1968_PAK,PAK,1968,15,0,15,1,0
1972_PAK,PAK,1972,25,0,25,1,0
1976_PAK,PAK,1976,24,0,24,1,0
1984_PAK,PAK,1984,31,0,31,1,0
1988_PAK,PAK,1988,30,0,30,1,0
1992_PAK,PAK,1992,27,0,27,1,0
1996_PAK,PAK,1996,23,1,24,0.958,0.042
2000_PAK,PAK,2000,26,1,27,0.963,0.037
2004_PAK,PAK,2004,24,2,26,0.923,0.077
2008_PAK,PAK,2008,19,2,21,0.905,0.095
2012_PAK,PAK,2012,19,2,21,0.905,0.095
2016_PAK,PAK,2016,4,3,7,0.571,0.429
1928_PAN,PAN,1928,1,0,1,1,0
1948_PAN,PAN,1948,1,0,1,1,0
1952_PAN,PAN,1952,1,0,1,1,0
1960_PAN,PAN,1960,2,4,6,0.333,0.667
1964_PAN,PAN,1964,6,4,10,0.6,0.4
1968_PAN,PAN,1968,16,0,16,1,0
1972_PAN,PAN,1972,7,0,7,1,0
1976_PAN,PAN,1976,7,1,8,0.875,0.125
1984_PAN,PAN,1984,7,1,8,0.875,0.125
1988_PAN,PAN,1988,6,0,6,1,0
1992_PAN,PAN,1992,5,0,5,1,0
1996_PAN,PAN,1996,5,2,7,0.714,0.286
2000_PAN,PAN,2000,4,2,6,0.667,0.333
2004_PAN,PAN,2004,3,1,4,0.75,0.25
2008_PAN,PAN,2008,3,2,5,0.6,0.4
2012_PAN,PAN,2012,6,2,8,0.75,0.25
2016_PAN,PAN,2016,4,6,10,0.4,0.6
1968_PAR,PAR,1968,1,0,1,1,0
1972_PAR,PAR,1972,3,0,3,1,0
1976_PAR,PAR,1976,4,0,4,1,0
1984_PAR,PAR,1984,14,0,14,1,0
1988_PAR,PAR,1988,10,0,10,1,0
1992_PAR,PAR,1992,24,3,27,0.889,0.111
1996_PAR,PAR,1996,6,1,7,0.857,0.143
2000_PAR,PAR,2000,2,3,5,0.4,0.6
2004_PAR,PAR,2004,20,2,22,0.909,0.091
2008_PAR,PAR,2008,3,4,7,0.429,0.571
2012_PAR,PAR,2012,4,4,8,0.5,0.5
2016_PAR,PAR,2016,6,5,11,0.545,0.455
1900_PER,PER,1900,1,0,1,1,0
1932_PER,PER,1932,2,0,2,1,0
1936_PER,PER,1936,40,0,40,1,0
1948_PER,PER,1948,41,0,41,1,0
1956_PER,PER,1956,8,0,8,1,0
1960_PER,PER,1960,31,0,31,1,0
1964_PER,PER,1964,30,1,31,0.968,0.032
1968_PER,PER,1968,16,12,28,0.571,0.429
1972_PER,PER,1972,17,3,20,0.85,0.15
1976_PER,PER,1976,0,13,13,0,1
1980_PER,PER,1980,14,14,28,0.5,0.5
1984_PER,PER,1984,19,16,35,0.543,0.457
1988_PER,PER,1988,7,14,21,0.333,0.667
1992_PER,PER,1992,12,4,16,0.75,0.25
1996_PER,PER,1996,15,14,29,0.517,0.483
2000_PER,PER,2000,8,13,21,0.381,0.619
2004_PER,PER,2004,7,5,12,0.583,0.417
2008_PER,PER,2008,7,6,13,0.538,0.462
2012_PER,PER,2012,9,7,16,0.563,0.438
2016_PER,PER,2016,17,12,29,0.586,0.414
1924_PHI,PHI,1924,1,0,1,1,0
1928_PHI,PHI,1928,4,0,4,1,0
1932_PHI,PHI,1932,8,0,8,1,0
1936_PHI,PHI,1936,28,0,28,1,0
1948_PHI,PHI,1948,26,0,26,1,0
1952_PHI,PHI,1952,25,0,25,1,0
1956_PHI,PHI,1956,35,4,39,0.897,0.103
1960_PHI,PHI,1960,36,4,40,0.9,0.1
1964_PHI,PHI,1964,40,7,47,0.851,0.149
1968_PHI,PHI,1968,45,4,49,0.918,0.082
1972_PHI,PHI,1972,50,5,55,0.909,0.091
1976_PHI,PHI,1976,13,1,14,0.929,0.071
1984_PHI,PHI,1984,15,4,19,0.789,0.211
1988_PHI,PHI,1988,27,5,32,0.844,0.156
1992_PHI,PHI,1992,25,2,27,0.926,0.074
1996_PHI,PHI,1996,8,4,12,0.667,0.333
2000_PHI,PHI,2000,11,9,20,0.55,0.45
2004_PHI,PHI,2004,12,4,16,0.75,0.25
2008_PHI,PHI,2008,10,5,15,0.667,0.333
2012_PHI,PHI,2012,7,4,11,0.636,0.364
2016_PHI,PHI,2016,7,6,13,0.538,0.462
1996_PLE,PLE,1996,1,0,1,1,0
2000_PLE,PLE,2000,1,1,2,0.5,0.5
2004_PLE,PLE,2004,2,1,3,0.667,0.333
2008_PLE,PLE,2008,2,2,4,0.5,0.5
2012_PLE,PLE,2012,3,2,5,0.6,0.4
2016_PLE,PLE,2016,4,2,6,0.667,0.333
2000_PLW,PLW,2000,2,3,5,0.4,0.6
2004_PLW,PLW,2004,2,2,4,0.5,0.5
2008_PLW,PLW,2008,3,2,5,0.6,0.4
2012_PLW,PLW,2012,2,3,5,0.4,0.6
2016_PLW,PLW,2016,3,2,5,0.6,0.4
1976_PNG,PNG,1976,6,0,6,1,0
1984_PNG,PNG,1984,4,3,7,0.571,0.429
1988_PNG,PNG,1988,9,2,11,0.818,0.182
1992_PNG,PNG,1992,12,1,13,0.923,0.077
1996_PNG,PNG,1996,11,0,11,1,0
2000_PNG,PNG,2000,2,3,5,0.4,0.6
2004_PNG,PNG,2004,2,2,4,0.5,0.5
2008_PNG,PNG,2008,3,4,7,0.429,0.571
2012_PNG,PNG,2012,4,4,8,0.5,0.5
2016_PNG,PNG,2016,6,2,8,0.75,0.25
1912_POL,POL,1912,1,0,1,1,0
1924_POL,POL,1924,71,1,72,0.986,0.014
1928_POL,POL,1928,106,11,117,0.906,0.094
1932_POL,POL,1932,57,9,66,0.864,0.136
1936_POL,POL,1936,147,17,164,0.896,0.104
1948_POL,POL,1948,60,7,67,0.896,0.104
1952_POL,POL,1952,130,25,155,0.839,0.161
1956_POL,POL,1956,93,22,115,0.809,0.191
1960_POL,POL,1960,163,35,198,0.823,0.177
1964_POL,POL,1964,155,36,191,0.812,0.188
1968_POL,POL,1968,163,45,208,0.784,0.216
1972_POL,POL,1972,291,46,337,0.864,0.136
1976_POL,POL,1976,223,40,263,0.848,0.152
1980_POL,POL,1980,261,75,336,0.777,0.223
1984_POL,POL,1984,24,6,30,0.8,0.2
1988_POL,POL,1988,139,36,175,0.794,0.206
1992_POL,POL,1992,190,64,254,0.748,0.252
1996_POL,POL,1996,126,39,165,0.764,0.236
2000_POL,POL,2000,129,58,187,0.69,0.31
2004_POL,POL,2004,132,62,194,0.68,0.32
2008_POL,POL,2008,156,101,257,0.607,0.393
2012_POL,POL,2012,124,86,210,0.59,0.41
2016_POL,POL,2016,139,95,234,0.594,0.406
1912_POR,POR,1912,6,0,6,1,0
1920_POR,POR,1920,13,0,13,1,0
1924_POR,POR,1924,28,0,28,1,0
1928_POR,POR,1928,32,0,32,1,0
1932_POR,POR,1932,6,0,6,1,0
1936_POR,POR,1936,19,0,19,1,0
1948_POR,POR,1948,48,0,48,1,0
1952_POR,POR,1952,69,3,72,0.958,0.042
1956_POR,POR,1956,12,0,12,1,0
1960_POR,POR,1960,60,5,65,0.923,0.077
1964_POR,POR,1964,19,1,20,0.95,0.05
1968_POR,POR,1968,19,1,20,0.95,0.05
1972_POR,POR,1972,29,0,29,1,0
1976_POR,POR,1976,19,0,19,1,0
1980_POR,POR,1980,10,1,11,0.909,0.091
1984_POR,POR,1984,29,9,38,0.763,0.237
1988_POR,POR,1988,60,10,70,0.857,0.143
1992_POR,POR,1992,68,22,90,0.756,0.244
1996_POR,POR,1996,83,24,107,0.776,0.224
2000_POR,POR,2000,48,13,61,0.787,0.213
2004_POR,POR,2004,64,17,81,0.79,0.21
2008_POR,POR,2008,51,26,77,0.662,0.338
2012_POR,POR,2012,44,32,76,0.579,0.421
2016_POR,POR,2016,61,29,90,0.678,0.322
1964_PRK,PRK,1964,6,7,13,0.462,0.538
1972_PRK,PRK,1972,23,20,43,0.535,0.465
1976_PRK,PRK,1976,36,2,38,0.947,0.053
1980_PRK,PRK,1980,39,8,47,0.83,0.17
1984_PRK,PRK,1984,3,3,6,0.5,0.5
1988_PRK,PRK,1988,3,3,6,0.5,0.5
1992_PRK,PRK,1992,45,39,84,0.536,0.464
1996_PRK,PRK,1996,15,9,24,0.625,0.375
2000_PRK,PRK,2000,14,17,31,0.452,0.548
2004_PRK,PRK,2004,13,23,36,0.361,0.639
2008_PRK,PRK,2008,21,37,58,0.362,0.638
2012_PRK,PRK,2012,15,37,52,0.288,0.712
2016_PRK,PRK,2016,11,20,31,0.355,0.645
1948_PUR,PUR,1948,9,0,9,1,0
1952_PUR,PUR,1952,21,0,21,1,0
1956_PUR,PUR,1956,10,0,10,1,0
1960_PUR,PUR,1960,26,1,27,0.963,0.037
1964_PUR,PUR,1964,30,2,32,0.938,0.063
1968_PUR,PUR,1968,54,4,58,0.931,0.069
1972_PUR,PUR,1972,53,0,53,1,0
1976_PUR,PUR,1976,73,7,80,0.912,0.087
1980_PUR,PUR,1980,3,0,3,1,0
1984_PUR,PUR,1984,44,8,52,0.846,0.154
1988_PUR,PUR,1988,52,4,56,0.929,0.071
1992_PUR,PUR,1992,71,6,77,0.922,0.078
1996_PUR,PUR,1996,47,22,69,0.681,0.319
2000_PUR,PUR,2000,23,6,29,0.793,0.207
2004_PUR,PUR,2004,32,11,43,0.744,0.256
2008_PUR,PUR,2008,17,5,22,0.773,0.227
2012_PUR,PUR,2012,19,6,25,0.76,0.24
2016_PUR,PUR,2016,13,27,40,0.325,0.675
1984_QAT,QAT,1984,24,0,24,1,0
1988_QAT,QAT,1988,10,0,10,1,0
1992_QAT,QAT,1992,28,0,28,1,0
1996_QAT,QAT,1996,12,0,12,1,0
2000_QAT,QAT,2000,17,0,17,1,0
2004_QAT,QAT,2004,15,0,15,1,0
2008_QAT,QAT,2008,20,0,20,1,0
2012_QAT,QAT,2012,8,4,12,0.667,0.333
2016_QAT,QAT,2016,35,2,37,0.946,0.054
1960_RHO,RHO,1960,9,1,10,0.9,0.1
2016_ROT,ROT,2016,6,4,10,0.6,0.4
1900_ROU,ROU,1900,1,0,1,1,0
1924_ROU,ROU,1924,35,0,35,1,0
1928_ROU,ROU,1928,29,2,31,0.935,0.065
1932_ROU,ROU,1932,5,0,5,1,0
1936_ROU,ROU,1936,65,3,68,0.956,0.044
1948_ROU,ROU,1948,7,0,7,1,0
1952_ROU,ROU,1952,119,11,130,0.915,0.085
1956_ROU,ROU,1956,52,17,69,0.754,0.246
1960_ROU,ROU,1960,82,16,98,0.837,0.163
1964_ROU,ROU,1964,135,30,165,0.818,0.182
1968_ROU,ROU,1968,95,17,112,0.848,0.152
1972_ROU,ROU,1972,145,27,172,0.843,0.157
1976_ROU,ROU,1976,135,54,189,0.714,0.286
1980_ROU,ROU,1980,187,76,263,0.711,0.289
1984_ROU,ROU,1984,87,56,143,0.608,0.392
1988_ROU,ROU,1988,37,42,79,0.468,0.532
1992_ROU,ROU,1992,119,77,196,0.607,0.393
1996_ROU,ROU,1996,98,67,165,0.594,0.406
2000_ROU,ROU,2000,71,74,145,0.49,0.51
2004_ROU,ROU,2004,50,58,108,0.463,0.537
2008_ROU,ROU,2008,40,61,101,0.396,0.604
2012_ROU,ROU,2012,55,50,105,0.524,0.476
2016_ROU,ROU,2016,34,61,95,0.358,0.642
1904_RSA,RSA,1904,8,0,8,1,0
1908_RSA,RSA,1908,14,0,14,1,0
1912_RSA,RSA,1912,21,0,21,1,0
1920_RSA,RSA,1920,38,1,39,0.974,0.026
1924_RSA,RSA,1924,30,0,30,1,0
1928_RSA,RSA,1928,18,6,24,0.75,0.25
1932_RSA,RSA,1932,10,2,12,0.833,0.167
1936_RSA,RSA,1936,27,5,32,0.844,0.156
1948_RSA,RSA,1948,34,1,35,0.971,0.029
1952_RSA,RSA,1952,60,4,64,0.938,0.063
1956_RSA,RSA,1956,44,6,50,0.88,0.12
1960_RSA,RSA,1960,54,5,59,0.915,0.085
1992_RSA,RSA,1992,68,25,93,0.731,0.269
1996_RSA,RSA,1996,64,20,84,0.762,0.238
2000_RSA,RSA,2000,89,38,127,0.701,0.299
2004_RSA,RSA,2004,66,40,106,0.623,0.377
2008_RSA,RSA,2008,75,59,134,0.56,0.44
2012_RSA,RSA,2012,68,56,124,0.548,0.452
2016_RSA,RSA,2016,93,42,135,0.689,0.311
1900_RUS,RUS,1900,4,0,4,1,0
1908_RUS,RUS,1908,6,0,6,1,0
1912_RUS,RUS,1912,159,0,159,1,0
1924_RUS,RUS,1924,2,1,3,0.667,0.333
1996_RUS,RUS,1996,232,158,390,0.595,0.405
2000_RUS,RUS,2000,241,194,435,0.554,0.446
2004_RUS,RUS,2004,244,202,446,0.547,0.453
2008_RUS,RUS,2008,231,223,454,0.509,0.491
2012_RUS,RUS,2012,203,226,429,0.473,0.527
2016_RUS,RUS,2016,142,142,284,0.5,0.5
1984_RWA,RWA,1984,2,1,3,0.667,0.333
1988_RWA,RWA,1988,3,3,6,0.5,0.5
1992_RWA,RWA,1992,7,3,10,0.7,0.3
1996_RWA,RWA,1996,4,0,4,1,0
2000_RWA,RWA,2000,3,2,5,0.6,0.4
2004_RWA,RWA,2004,3,2,5,0.6,0.4
2008_RWA,RWA,2008,2,2,4,0.5,0.5
2012_RWA,RWA,2012,5,2,7,0.714,0.286
2016_RWA,RWA,2016,4,3,7,0.571,0.429
1952_SAA,SAA,1952,31,5,36,0.861,0.139
1984_SAM,SAM,1984,8,0,8,1,0
1988_SAM,SAM,1988,11,0,11,1,0
1992_SAM,SAM,1992,5,0,5,1,0
1996_SAM,SAM,1996,4,1,5,0.8,0.2
2000_SAM,SAM,2000,4,1,5,0.8,0.2
2004_SAM,SAM,2004,2,1,3,0.667,0.333
2008_SAM,SAM,2008,4,2,6,0.667,0.333
2012_SAM,SAM,2012,5,3,8,0.625,0.375
2016_SAM,SAM,2016,5,3,8,0.625,0.375
1996_SCG,SCG,1996,59,9,68,0.868,0.132
2000_SCG,SCG,2000,92,17,109,0.844,0.156
2004_SCG,SCG,2004,78,7,85,0.918,0.082
1964_SEN,SEN,1964,12,0,12,1,0
1968_SEN,SEN,1968,21,0,21,1,0
1972_SEN,SEN,1972,38,0,38,1,0
1976_SEN,SEN,1976,19,2,21,0.905,0.095
1980_SEN,SEN,1980,30,2,32,0.938,0.063
1984_SEN,SEN,1984,24,1,25,0.96,0.04
1988_SEN,SEN,1988,22,1,23,0.957,0.043
1992_SEN,SEN,1992,20,2,22,0.909,0.091
1996_SEN,SEN,1996,11,0,11,1,0
2000_SEN,SEN,2000,7,19,26,0.269,0.731
2004_SEN,SEN,2004,6,9,15,0.4,0.6
2008_SEN,SEN,2008,8,7,15,0.533,0.467
2012_SEN,SEN,2012,24,7,31,0.774,0.226
2016_SEN,SEN,2016,6,16,22,0.273,0.727
1980_SEY,SEY,1980,9,2,11,0.818,0.182
1984_SEY,SEY,1984,8,1,9,0.889,0.111
1992_SEY,SEY,1992,10,1,11,0.909,0.091
1996_SEY,SEY,1996,8,1,9,0.889,0.111
2000_SEY,SEY,2000,6,3,9,0.667,0.333
2004_SEY,SEY,2004,7,2,9,0.778,0.222
2008_SEY,SEY,2008,6,3,9,0.667,0.333
2012_SEY,SEY,2012,4,2,6,0.667,0.333
2016_SEY,SEY,2016,8,2,10,0.8,0.2
1948_SGP,SGP,1948,1,0,1,1,0
1952_SGP,SGP,1952,4,1,5,0.8,0.2
1956_SGP,SGP,1956,47,2,49,0.959,0.041
1960_SGP,SGP,1960,5,0,5,1,0
1968_SGP,SGP,1968,4,0,4,1,0
1972_SGP,SGP,1972,5,2,7,0.714,0.286
1976_SGP,SGP,1976,3,1,4,0.75,0.25
1984_SGP,SGP,1984,5,0,5,1,0
1988_SGP,SGP,1988,7,1,8,0.875,0.125
1992_SGP,SGP,1992,11,3,14,0.786,0.214
1996_SGP,SGP,1996,9,5,14,0.643,0.357
2000_SGP,SGP,2000,8,6,14,0.571,0.429
2004_SGP,SGP,2004,6,10,16,0.375,0.625
2008_SGP,SGP,2008,11,14,25,0.44,0.56
2012_SGP,SGP,2012,8,15,23,0.348,0.652
2016_SGP,SGP,2016,9,16,25,0.36,0.64
1996_SKN,SKN,1996,4,6,10,0.4,0.6
2000_SKN,SKN,2000,1,1,2,0.5,0.5
2004_SKN,SKN,2004,1,1,2,0.5,0.5
2008_SKN,SKN,2008,1,3,4,0.25,0.75
2012_SKN,SKN,2012,4,0,4,1,0
2016_SKN,SKN,2016,5,1,6,0.833,0.167
1968_SLE,SLE,1968,3,0,3,1,0
1980_SLE,SLE,1980,12,2,14,0.857,0.143
1984_SLE,SLE,1984,6,1,7,0.857,0.143
1988_SLE,SLE,1988,11,1,12,0.917,0.083
1992_SLE,SLE,1992,9,2,11,0.818,0.182
1996_SLE,SLE,1996,10,4,14,0.714,0.286
2000_SLE,SLE,2000,2,1,3,0.667,0.333
2004_SLE,SLE,2004,1,1,2,0.5,0.5
2008_SLE,SLE,2008,2,1,3,0.667,0.333
2012_SLE,SLE,2012,1,1,2,0.5,0.5
2016_SLE,SLE,2016,2,2,4,0.5,0.5
1992_SLO,SLO,1992,49,13,62,0.79,0.21
1996_SLO,SLO,1996,25,12,37,0.676,0.324
2000_SLO,SLO,2000,55,19,74,0.743,0.257
2004_SLO,SLO,2004,56,23,79,0.709,0.291
2008_SLO,SLO,2008,40,21,61,0.656,0.344
2012_SLO,SLO,2012,28,37,65,0.431,0.569
2016_SLO,SLO,2016,39,24,63,0.619,0.381
1960_SMR,SMR,1960,9,0,9,1,0
1968_SMR,SMR,1968,4,0,4,1,0
1972_SMR,SMR,1972,7,0,7,1,0
1976_SMR,SMR,1976,10,2,12,0.833,0.167
1980_SMR,SMR,1980,16,0,16,1,0
1984_SMR,SMR,1984,21,1,22,0.955,0.045
1988_SMR,SMR,1988,16,0,16,1,0
1992_SMR,SMR,1992,19,1,20,0.95,0.05
1996_SMR,SMR,1996,6,1,7,0.857,0.143
2000_SMR,SMR,2000,3,1,4,0.75,0.25
2004_SMR,SMR,2004,4,1,5,0.8,0.2
2008_SMR,SMR,2008,2,2,4,0.5,0.5
2012_SMR,SMR,2012,1,3,4,0.25,0.75
2016_SMR,SMR,2016,2,2,4,0.5,0.5
1984_SOL,SOL,1984,3,0,3,1,0
1988_SOL,SOL,1988,4,0,4,1,0
1992_SOL,SOL,1992,1,0,1,1,0
1996_SOL,SOL,1996,3,1,4,0.75,0.25
2000_SOL,SOL,2000,1,1,2,0.5,0.5
2004_SOL,SOL,2004,1,1,2,0.5,0.5
2008_SOL,SOL,2008,1,2,3,0.333,0.667
2012_SOL,SOL,2012,2,2,4,0.5,0.5
2016_SOL,SOL,2016,1,2,3,0.333,0.667
1972_SOM,SOM,1972,3,0,3,1,0
1984_SOM,SOM,1984,7,0,7,1,0
1988_SOM,SOM,1988,5,0,5,1,0
1996_SOM,SOM,1996,4,0,4,1,0
2000_SOM,SOM,2000,1,1,2,0.5,0.5
2004_SOM,SOM,2004,1,1,2,0.5,0.5
2008_SOM,SOM,2008,1,1,2,0.5,0.5
2012_SOM,SOM,2012,1,1,2,0.5,0.5
2016_SOM,SOM,2016,1,1,2,0.5,0.5
1912_SRB,SRB,1912,2,0,2,1,0
2008_SRB,SRB,2008,63,24,87,0.724,0.276
2012_SRB,SRB,2012,80,36,116,0.69,0.31
2016_SRB,SRB,2016,58,45,103,0.563,0.437
1948_SRI,SRI,1948,7,0,7,1,0
1952_SRI,SRI,1952,5,0,5,1,0
1956_SRI,SRI,1956,3,0,3,1,0
1960_SRI,SRI,1960,5,0,5,1,0
1964_SRI,SRI,1964,6,0,6,1,0
1968_SRI,SRI,1968,3,0,3,1,0
1972_SRI,SRI,1972,4,0,4,1,0
1980_SRI,SRI,1980,4,0,4,1,0
1984_SRI,SRI,1984,4,0,4,1,0
1988_SRI,SRI,1988,4,2,6,0.667,0.333
1992_SRI,SRI,1992,5,6,11,0.455,0.545
1996_SRI,SRI,1996,5,4,9,0.556,0.444
2000_SRI,SRI,2000,9,9,18,0.5,0.5
2004_SRI,SRI,2004,4,3,7,0.571,0.429
2008_SRI,SRI,2008,4,4,8,0.5,0.5
2012_SRI,SRI,2012,4,3,7,0.571,0.429
2016_SRI,SRI,2016,7,2,9,0.778,0.222
2016_SSD,SSD,2016,2,1,3,0.667,0.333
1996_STP,STP,1996,1,1,2,0.5,0.5
2000_STP,STP,2000,1,1,2,0.5,0.5
2004_STP,STP,2004,1,1,2,0.5,0.5
2008_STP,STP,2008,2,1,3,0.667,0.333
2012_STP,STP,2012,1,1,2,0.5,0.5
2016_STP,STP,2016,2,1,3,0.667,0.333
1960_SUD,SUD,1960,10,0,10,1,0
1968_SUD,SUD,1968,5,0,5,1,0
1972_SUD,SUD,1972,26,0,26,1,0
1984_SUD,SUD,1984,7,0,7,1,0
1988_SUD,SUD,1988,8,0,8,1,0
1992_SUD,SUD,1992,6,0,6,1,0
1996_SUD,SUD,1996,4,0,4,1,0
2000_SUD,SUD,2000,2,1,3,0.667,0.333
2004_SUD,SUD,2004,3,1,4,0.75,0.25
2008_SUD,SUD,2008,5,4,9,0.556,0.444
2012_SUD,SUD,2012,4,2,6,0.667,0.333
2016_SUD,SUD,2016,4,2,6,0.667,0.333
1896_SUI,SUI,1896,3,0,3,1,0
1900_SUI,SUI,1900,17,1,18,0.944,0.056
1904_SUI,SUI,1904,3,0,3,1,0
1908_SUI,SUI,1908,1,0,1,1,0
1912_SUI,SUI,1912,7,0,7,1,0
1920_SUI,SUI,1920,77,0,77,1,0
1924_SUI,SUI,1924,165,5,170,0.971,0.029
1928_SUI,SUI,1928,171,2,173,0.988,0.012
1932_SUI,SUI,1932,14,0,14,1,0
1936_SUI,SUI,1936,214,10,224,0.955,0.045
1948_SUI,SUI,1948,237,19,256,0.926,0.074
1952_SUI,SUI,1952,194,18,212,0.915,0.085
1956_SUI,SUI,1956,60,8,68,0.882,0.118
1960_SUI,SUI,1960,161,9,170,0.947,0.053
1964_SUI,SUI,1964,125,13,138,0.906,0.094
1968_SUI,SUI,1968,110,9,119,0.924,0.076
1972_SUI,SUI,1972,168,35,203,0.828,0.172
1976_SUI,SUI,1976,99,10,109,0.908,0.092
1980_SUI,SUI,1980,100,17,117,0.855,0.145
1984_SUI,SUI,1984,131,40,171,0.766,0.234
1988_SUI,SUI,1988,128,41,169,0.757,0.243
1992_SUI,SUI,1992,130,46,176,0.739,0.261
1996_SUI,SUI,1996,72,43,115,0.626,0.374
2000_SUI,SUI,2000,64,38,102,0.627,0.373
2004_SUI,SUI,2004,59,39,98,0.602,0.398
2008_SUI,SUI,2008,47,36,83,0.566,0.434
2012_SUI,SUI,2012,70,28,98,0.714,0.286
2016_SUI,SUI,2016,57,45,102,0.559,0.441
1968_SUR,SUR,1968,1,0,1,1,0
1972_SUR,SUR,1972,2,0,2,1,0
1976_SUR,SUR,1976,3,0,3,1,0
1984_SUR,SUR,1984,5,0,5,1,0
1988_SUR,SUR,1988,4,2,6,0.667,0.333
1992_SUR,SUR,1992,5,1,6,0.833,0.167
1996_SUR,SUR,1996,5,2,7,0.714,0.286
2000_SUR,SUR,2000,2,2,4,0.5,0.5
2004_SUR,SUR,2004,2,2,4,0.5,0.5
2008_SUR,SUR,2008,2,2,4,0.5,0.5
2012_SUR,SUR,2012,3,2,5,0.6,0.4
2016_SUR,SUR,2016,4,2,6,0.667,0.333
1996_SVK,SVK,1996,58,13,71,0.817,0.183
2000_SVK,SVK,2000,81,27,108,0.75,0.25
2004_SVK,SVK,2004,48,16,64,0.75,0.25
2008_SVK,SVK,2008,35,22,57,0.614,0.386
2012_SVK,SVK,2012,26,21,47,0.553,0.447
2016_SVK,SVK,2016,32,19,51,0.627,0.373
1896_SWE,SWE,1896,1,0,1,1,0
1900_SWE,SWE,1900,10,0,10,1,0
1908_SWE,SWE,1908,165,3,168,0.982,0.018
1912_SWE,SWE,1912,421,23,444,0.948,0.052
1920_SWE,SWE,1920,247,13,260,0.95,0.05
1924_SWE,SWE,1924,177,13,190,0.932,0.068
1928_SWE,SWE,1928,111,13,124,0.895,0.105
1932_SWE,SWE,1932,89,4,93,0.957,0.043
1936_SWE,SWE,1936,193,9,202,0.955,0.045
1948_SWE,SWE,1948,203,20,223,0.91,0.09
1952_SWE,SWE,1952,239,32,271,0.882,0.118
1956_SWE,SWE,1956,133,22,155,0.858,0.142
1960_SWE,SWE,1960,156,25,181,0.862,0.138
1964_SWE,SWE,1964,125,26,151,0.828,0.172
1968_SWE,SWE,1968,145,23,168,0.863,0.137
1972_SWE,SWE,1972,153,36,189,0.81,0.19
1976_SWE,SWE,1976,129,26,155,0.832,0.168
1980_SWE,SWE,1980,171,35,206,0.83,0.17
1984_SWE,SWE,1984,181,52,233,0.777,0.223
1988_SWE,SWE,1988,202,50,252,0.802,0.198
1992_SWE,SWE,1992,199,61,260,0.765,0.235
1996_SWE,SWE,1996,111,66,177,0.627,0.373
2000_SWE,SWE,2000,98,52,150,0.653,0.347
2004_SWE,SWE,2004,62,53,115,0.539,0.461
2008_SWE,SWE,2008,50,73,123,0.407,0.593
2012_SWE,SWE,2012,55,78,133,0.414,0.586
2016_SWE,SWE,2016,64,86,150,0.427,0.573
1972_SWZ,SWZ,1972,2,0,2,1,0
1984_SWZ,SWZ,1984,8,0,8,1,0
1988_SWZ,SWZ,1988,11,0,11,1,0
1992_SWZ,SWZ,1992,7,0,7,1,0
1996_SWZ,SWZ,1996,5,1,6,0.833,0.167
2000_SWZ,SWZ,2000,4,2,6,0.667,0.333
2004_SWZ,SWZ,2004,2,1,3,0.667,0.333
2008_SWZ,SWZ,2008,2,2,4,0.5,0.5
2012_SWZ,SWZ,2012,2,1,3,0.667,0.333
2016_SWZ,SWZ,2016,1,1,2,0.5,0.5
1948_SYR,SYR,1948,1,0,1,1,0
1968_SYR,SYR,1968,2,0,2,1,0
1972_SYR,SYR,1972,4,1,5,0.8,0.2
1980_SYR,SYR,1980,65,2,67,0.97,0.03
1984_SYR,SYR,1984,9,0,9,1,0
1988_SYR,SYR,1988,13,0,13,1,0
1992_SYR,SYR,1992,7,1,8,0.875,0.125
1996_SYR,SYR,1996,6,1,7,0.857,0.143
2000_SYR,SYR,2000,6,2,8,0.75,0.25
2004_SYR,SYR,2004,5,1,6,0.833,0.167
2008_SYR,SYR,2008,6,1,7,0.857,0.143
2012_SYR,SYR,2012,6,4,10,0.6,0.4
2016_SYR,SYR,2016,4,3,7,0.571,0.429
1964_TAN,TAN,1964,4,0,4,1,0
1968_TAN,TAN,1968,4,0,4,1,0
1972_TAN,TAN,1972,15,0,15,1,0
1980_TAN,TAN,1980,36,5,41,0.878,0.122
1984_TAN,TAN,1984,16,2,18,0.889,0.111
1988_TAN,TAN,1988,10,0,10,1,0
1992_TAN,TAN,1992,9,0,9,1,0
1996_TAN,TAN,1996,6,1,7,0.857,0.143
2000_TAN,TAN,2000,3,1,4,0.75,0.25
2004_TAN,TAN,2004,6,2,8,0.75,0.25
2008_TAN,TAN,2008,7,2,9,0.778,0.222
2012_TAN,TAN,2012,4,2,6,0.667,0.333
2016_TAN,TAN,2016,5,2,7,0.714,0.286
1920_TCH,TCH,1920,118,1,119,0.992,0.008
1924_TCH,TCH,1924,156,4,160,0.975,0.025
1928_TCH,TCH,1928,92,2,94,0.979,0.021
1932_TCH,TCH,1932,31,0,31,1,0
1936_TCH,TCH,1936,215,19,234,0.919,0.081
1948_TCH,TCH,1948,114,20,134,0.851,0.149
1952_TCH,TCH,1952,108,13,121,0.893,0.107
1956_TCH,TCH,1956,86,18,104,0.827,0.173
1960_TCH,TCH,1960,119,18,137,0.869,0.131
1964_TCH,TCH,1964,131,19,150,0.873,0.127
1968_TCH,TCH,1968,135,34,169,0.799,0.201
1972_TCH,TCH,1972,182,40,222,0.82,0.18
1976_TCH,TCH,1976,172,49,221,0.778,0.222
1980_TCH,TCH,1980,196,54,250,0.784,0.216
1984_TCH,TCH,1984,38,12,50,0.76,0.24
1988_TCH,TCH,1988,159,63,222,0.716,0.284
1992_TCH,TCH,1992,201,81,282,0.713,0.287
1984_TGA,TGA,1984,7,0,7,1,0
1988_TGA,TGA,1988,4,1,5,0.8,0.2
1992_TGA,TGA,1992,5,0,5,1,0
1996_TGA,TGA,1996,4,1,5,0.8,0.2
2000_TGA,TGA,2000,2,1,3,0.667,0.333
2004_TGA,TGA,2004,4,1,5,0.8,0.2
2008_TGA,TGA,2008,2,1,3,0.667,0.333
2012_TGA,TGA,2012,2,1,3,0.667,0.333
2016_TGA,TGA,2016,4,3,7,0.571,0.429
1952_THA,THA,1952,8,0,8,1,0
1956_THA,THA,1956,35,0,35,1,0
1960_THA,THA,1960,20,0,20,1,0
1964_THA,THA,1964,47,7,54,0.87,0.13
1968_THA,THA,1968,41,0,41,1,0
1972_THA,THA,1972,33,0,33,1,0
1976_THA,THA,1976,39,3,42,0.929,0.071
1984_THA,THA,1984,25,10,35,0.714,0.286
1988_THA,THA,1988,12,2,14,0.857,0.143
1992_THA,THA,1992,23,23,46,0.5,0.5
1996_THA,THA,1996,25,12,37,0.676,0.324
2000_THA,THA,2000,34,18,52,0.654,0.346
2004_THA,THA,2004,24,18,42,0.571,0.429
2008_THA,THA,2008,22,25,47,0.468,0.532
2012_THA,THA,2012,19,18,37,0.514,0.486
2016_THA,THA,2016,26,28,54,0.481,0.519
1996_TJK,TJK,1996,6,2,8,0.75,0.25
2000_TJK,TJK,2000,2,2,4,0.5,0.5
2004_TJK,TJK,2004,5,4,9,0.556,0.444
2008_TJK,TJK,2008,12,3,15,0.8,0.2
2012_TJK,TJK,2012,13,3,16,0.813,0.188
2016_TJK,TJK,2016,5,2,7,0.714,0.286
1996_TKM,TKM,1996,4,3,7,0.571,0.429
2000_TKM,TKM,2000,4,4,8,0.5,0.5
2004_TKM,TKM,2004,6,3,9,0.667,0.333
2008_TKM,TKM,2008,6,4,10,0.6,0.4
2012_TKM,TKM,2012,7,3,10,0.7,0.3
2016_TKM,TKM,2016,4,5,9,0.444,0.556
2004_TLS,TLS,2004,1,1,2,0.5,0.5
2008_TLS,TLS,2008,0,1,1,0,1
2012_TLS,TLS,2012,1,1,2,0.5,0.5
2016_TLS,TLS,2016,1,2,3,0.333,0.667
1972_TOG,TOG,1972,7,0,7,1,0
1984_TOG,TOG,1984,6,0,6,1,0
1988_TOG,TOG,1988,6,0,6,1,0
1992_TOG,TOG,1992,6,0,6,1,0
1996_TOG,TOG,1996,5,0,5,1,0
2000_TOG,TOG,2000,2,1,3,0.667,0.333
2004_TOG,TOG,2004,2,1,3,0.667,0.333
2008_TOG,TOG,2008,3,1,4,0.75,0.25
2012_TOG,TOG,2012,4,2,6,0.667,0.333
2016_TOG,TOG,2016,2,3,5,0.4,0.6
1956_TPE,TPE,1956,20,0,20,1,0
1960_TPE,TPE,1960,24,3,27,0.889,0.111
1964_TPE,TPE,1964,37,3,40,0.925,0.075
1968_TPE,TPE,1968,35,8,43,0.814,0.186
1972_TPE,TPE,1972,20,6,26,0.769,0.231
1976_TPE,TPE,1976,6,0,6,1,0
1984_TPE,TPE,1984,41,9,50,0.82,0.18
1988_TPE,TPE,1988,54,20,74,0.73,0.27
1992_TPE,TPE,1992,31,8,39,0.795,0.205
1996_TPE,TPE,1996,32,42,74,0.432,0.568
2000_TPE,TPE,2000,21,34,55,0.382,0.618
2004_TPE,TPE,2004,49,39,88,0.557,0.443
2008_TPE,TPE,2008,43,36,79,0.544,0.456
2012_TPE,TPE,2012,19,25,44,0.432,0.568
2016_TPE,TPE,2016,26,29,55,0.473,0.527
1948_TTO,TTO,1948,5,0,5,1,0
1952_TTO,TTO,1952,2,0,2,1,0
1956_TTO,TTO,1956,6,0,6,1,0
1964_TTO,TTO,1964,13,0,13,1,0
1968_TTO,TTO,1968,19,0,19,1,0
1972_TTO,TTO,1972,18,1,19,0.947,0.053
1976_TTO,TTO,1976,13,0,13,1,0
1980_TTO,TTO,1980,9,0,9,1,0
1984_TTO,TTO,1984,11,5,16,0.688,0.313
1988_TTO,TTO,1988,4,2,6,0.667,0.333
1992_TTO,TTO,1992,7,0,7,1,0
1996_TTO,TTO,1996,8,4,12,0.667,0.333
2000_TTO,TTO,2000,14,5,19,0.737,0.263
2004_TTO,TTO,2004,10,9,19,0.526,0.474
2008_TTO,TTO,2008,17,11,28,0.607,0.393
2012_TTO,TTO,2012,18,7,25,0.72,0.28
2016_TTO,TTO,2016,18,10,28,0.643,0.357
1960_TUN,TUN,1960,42,0,42,1,0
1964_TUN,TUN,1964,9,0,9,1,0
1968_TUN,TUN,1968,7,0,7,1,0
1972_TUN,TUN,1972,35,0,35,1,0
1976_TUN,TUN,1976,14,1,15,0.933,0.067
1984_TUN,TUN,1984,22,1,23,0.957,0.043
1988_TUN,TUN,1988,39,2,41,0.951,0.049
1992_TUN,TUN,1992,11,2,13,0.846,0.154
1996_TUN,TUN,1996,45,6,51,0.882,0.118
2000_TUN,TUN,2000,40,7,47,0.851,0.149
2004_TUN,TUN,2004,44,10,54,0.815,0.185
2008_TUN,TUN,2008,14,12,26,0.538,0.462
2012_TUN,TUN,2012,63,20,83,0.759,0.241
2016_TUN,TUN,2016,41,20,61,0.672,0.328
1912_TUR,TUR,1912,2,0,2,1,0
1924_TUR,TUR,1924,22,0,22,1,0
1928_TUR,TUR,1928,31,0,31,1,0
1932_TUR,TUR,1932,1,0,1,1,0
1936_TUR,TUR,1936,52,2,54,0.963,0.037
1948_TUR,TUR,1948,61,1,62,0.984,0.016
1952_TUR,TUR,1952,51,0,51,1,0
1956_TUR,TUR,1956,23,0,23,1,0
1960_TUR,TUR,1960,48,3,51,0.941,0.059
1964_TUR,TUR,1964,28,0,28,1,0
1968_TUR,TUR,1968,40,0,40,1,0
1972_TUR,TUR,1972,42,1,43,0.977,0.023
1976_TUR,TUR,1976,35,1,36,0.972,0.028
1984_TUR,TUR,1984,52,1,53,0.981,0.019
1988_TUR,TUR,1988,44,5,49,0.898,0.102
1992_TUR,TUR,1992,44,5,49,0.898,0.102
1996_TUR,TUR,1996,44,9,53,0.83,0.17
2000_TUR,TUR,2000,42,15,57,0.737,0.263
2004_TUR,TUR,2004,44,20,64,0.688,0.313
2008_TUR,TUR,2008,48,19,67,0.716,0.284
2012_TUR,TUR,2012,48,64,112,0.429,0.571
2016_TUR,TUR,2016,53,47,100,0.53,0.47
2008_TUV,TUV,2008,2,1,3,0.667,0.333
2012_TUV,TUV,2012,2,1,3,0.667,0.333
2016_TUV,TUV,2016,1,0,1,1,0
1984_UAE,UAE,1984,7,0,7,1,0
1988_UAE,UAE,1988,12,0,12,1,0
1992_UAE,UAE,1992,13,0,13,1,0
1996_UAE,UAE,1996,4,0,4,1,0
2000_UAE,UAE,2000,4,0,4,1,0
2004_UAE,UAE,2004,4,0,4,1,0
2008_UAE,UAE,2008,6,2,8,0.75,0.25
2012_UAE,UAE,2012,24,2,26,0.923,0.077
2016_UAE,UAE,2016,9,3,12,0.75,0.25
1960_UAR,UAR,1960,74,0,74,1,0
1956_UGA,UGA,1956,3,0,3,1,0
1960_UGA,UGA,1960,10,0,10,1,0
1964_UGA,UGA,1964,11,2,13,0.846,0.154
1968_UGA,UGA,1968,11,0,11,1,0
1972_UGA,UGA,1972,31,2,33,0.939,0.061
1980_UGA,UGA,1980,13,0,13,1,0
1984_UGA,UGA,1984,24,2,26,0.923,0.077
1988_UGA,UGA,1988,20,4,24,0.833,0.167
1992_UGA,UGA,1992,6,2,8,0.75,0.25
1996_UGA,UGA,1996,7,3,10,0.7,0.3
2000_UGA,UGA,2000,9,4,13,0.692,0.308
2004_UGA,UGA,2004,9,2,11,0.818,0.182
2008_UGA,UGA,2008,9,2,11,0.818,0.182
2012_UGA,UGA,2012,11,4,15,0.733,0.267
2016_UGA,UGA,2016,14,7,21,0.667,0.333
1996_UKR,UKR,1996,146,85,231,0.632,0.368
2000_UKR,UKR,2000,139,91,230,0.604,0.396
2004_UKR,UKR,2004,124,115,239,0.519,0.481
2008_UKR,UKR,2008,127,116,243,0.523,0.477
2012_UKR,UKR,2012,119,111,230,0.517,0.483
2016_UKR,UKR,2016,87,117,204,0.426,0.574
1912_UNK,UNK,1912,2,0,2,1,0
1952_URS,URS,1952,255,40,295,0.864,0.136
1956_URS,URS,1956,289,45,334,0.865,0.135
1960_URS,URS,1960,281,64,345,0.814,0.186
1964_URS,URS,1964,307,79,386,0.795,0.205
1968_URS,URS,1968,300,86,386,0.777,0.223
1972_URS,URS,1972,353,94,447,0.79,0.21
1976_URS,URS,1976,344,145,489,0.703,0.297
1980_URS,URS,1980,403,172,575,0.701,0.299
1984_URS,URS,1984,74,25,99,0.747,0.253
1988_URS,URS,1988,397,185,582,0.682,0.318
1924_URU,URU,1924,26,0,26,1,0
1928_URU,URU,1928,17,0,17,1,0
1932_URU,URU,1932,2,0,2,1,0
1936_URU,URU,1936,37,0,37,1,0
1948_URU,URU,1948,60,1,61,0.984,0.016
1952_URU,URU,1952,31,1,32,0.969,0.031
1956_URU,URU,1956,21,0,21,1,0
1960_URU,URU,1960,34,0,34,1,0
1964_URU,URU,1964,23,0,23,1,0
1968_URU,URU,1968,21,6,27,0.778,0.222
1972_URU,URU,1972,10,3,13,0.769,0.231
1976_URU,URU,1976,7,2,9,0.778,0.222
1984_URU,URU,1984,17,1,18,0.944,0.056
1988_URU,URU,1988,14,1,15,0.933,0.067
1992_URU,URU,1992,16,0,16,1,0
1996_URU,URU,1996,12,2,14,0.857,0.143
2000_URU,URU,2000,12,3,15,0.8,0.2
2004_URU,URU,2004,13,2,15,0.867,0.133
2008_URU,URU,2008,9,3,12,0.75,0.25
2012_URU,URU,2012,24,3,27,0.889,0.111
2016_URU,URU,2016,12,5,17,0.706,0.294
1896_USA,USA,1896,14,0,14,1,0
1900_USA,USA,1900,68,7,75,0.907,0.093
1904_USA,USA,1904,518,6,524,0.989,0.011
1908_USA,USA,1908,122,0,122,1,0
1912_USA,USA,1912,174,0,174,1,0
1920_USA,USA,1920,274,14,288,0.951,0.049
1924_USA,USA,1924,297,26,323,0.92,0.08
1928_USA,USA,1928,257,47,304,0.845,0.155
1932_USA,USA,1932,458,80,538,0.851,0.149
1936_USA,USA,1936,359,55,414,0.867,0.133
1948_USA,USA,1948,321,48,369,0.87,0.13
1952_USA,USA,1952,301,51,352,0.855,0.145
1956_USA,USA,1956,314,57,371,0.846,0.154
1960_USA,USA,1960,302,69,371,0.814,0.186
1964_USA,USA,1964,338,98,436,0.775,0.225
1968_USA,USA,1968,349,104,453,0.77,0.23
1972_USA,USA,1972,393,110,503,0.781,0.219
1976_USA,USA,1976,354,148,502,0.705,0.295
1980_USA,USA,1980,76,25,101,0.752,0.248
1984_USA,USA,1984,415,213,628,0.661,0.339
1988_USA,USA,1988,418,226,644,0.649,0.351
1992_USA,USA,1992,453,240,693,0.654,0.346
1996_USA,USA,1996,375,273,648,0.579,0.421
2000_USA,USA,2000,333,253,586,0.568,0.432
2004_USA,USA,2004,279,254,533,0.523,0.477
2008_USA,USA,2008,306,282,588,0.52,0.48
2012_USA,USA,2012,262,268,530,0.494,0.506
2016_USA,USA,2016,264,291,555,0.476,0.524
1996_UZB,UZB,1996,63,8,71,0.887,0.113
2000_UZB,UZB,2000,52,18,70,0.743,0.257
2004_UZB,UZB,2004,51,18,69,0.739,0.261
2008_UZB,UZB,2008,41,15,56,0.732,0.268
2012_UZB,UZB,2012,36,17,53,0.679,0.321
2016_UZB,UZB,2016,47,23,70,0.671,0.329
1988_VAN,VAN,1988,3,1,4,0.75,0.25
1992_VAN,VAN,1992,4,2,6,0.667,0.333
1996_VAN,VAN,1996,3,1,4,0.75,0.25
2000_VAN,VAN,2000,2,1,3,0.667,0.333
2004_VAN,VAN,2004,1,1,2,0.5,0.5
2008_VAN,VAN,2008,1,2,3,0.333,0.667
2012_VAN,VAN,2012,3,2,5,0.6,0.4
2016_VAN,VAN,2016,4,0,4,1,0
1932_VEN,VEN,1932,1,0,1,1,0
1948_VEN,VEN,1948,1,0,1,1,0
1952_VEN,VEN,1952,36,2,38,0.947,0.053
1956_VEN,VEN,1956,22,0,22,1,0
1960_VEN,VEN,1960,31,5,36,0.861,0.139
1964_VEN,VEN,1964,15,1,16,0.938,0.063
1968_VEN,VEN,1968,23,0,23,1,0
1972_VEN,VEN,1972,20,3,23,0.87,0.13
1976_VEN,VEN,1976,23,9,32,0.719,0.281
1980_VEN,VEN,1980,37,0,37,1,0
1984_VEN,VEN,1984,25,1,26,0.962,0.038
1988_VEN,VEN,1988,15,2,17,0.882,0.118
1992_VEN,VEN,1992,22,4,26,0.846,0.154
1996_VEN,VEN,1996,34,5,39,0.872,0.128
2000_VEN,VEN,2000,36,14,50,0.72,0.28
2004_VEN,VEN,2004,33,15,48,0.688,0.313
2008_VEN,VEN,2008,57,51,108,0.528,0.472
2012_VEN,VEN,2012,42,26,68,0.618,0.382
2016_VEN,VEN,2016,61,24,85,0.718,0.282
1980_VIE,VIE,1980,22,8,30,0.733,0.267
1988_VIE,VIE,1988,8,1,9,0.889,0.111
1992_VIE,VIE,1992,2,5,7,0.286,0.714
1996_VIE,VIE,1996,3,3,6,0.5,0.5
2000_VIE,VIE,2000,3,4,7,0.429,0.571
2004_VIE,VIE,2004,6,5,11,0.545,0.455
2008_VIE,VIE,2008,7,6,13,0.538,0.462
2012_VIE,VIE,2012,6,12,18,0.333,0.667
2016_VIE,VIE,2016,10,12,22,0.455,0.545
1988_VIN,VIN,1988,5,1,6,0.833,0.167
1992_VIN,VIN,1992,4,2,6,0.667,0.333
1996_VIN,VIN,1996,7,1,8,0.875,0.125
2000_VIN,VIN,2000,2,2,4,0.5,0.5
2004_VIN,VIN,2004,2,1,3,0.667,0.333
2008_VIN,VIN,2008,1,1,2,0.5,0.5
2012_VIN,VIN,2012,2,1,3,0.667,0.333
2016_VIN,VIN,2016,2,2,4,0.5,0.5
1952_VNM,VNM,1952,8,0,8,1,0
1956_VNM,VNM,1956,6,0,6,1,0
1960_VNM,VNM,1960,3,0,3,1,0
1964_VNM,VNM,1964,16,0,16,1,0
1968_VNM,VNM,1968,7,2,9,0.778,0.222
1972_VNM,VNM,1972,2,0,2,1,0
1960_WIF,WIF,1960,13,0,13,1,0
1984_YAR,YAR,1984,2,0,2,1,0
1988_YAR,YAR,1988,8,0,8,1,0
1992_YEM,YEM,1992,8,0,8,1,0
1996_YEM,YEM,1996,4,0,4,1,0
2000_YEM,YEM,2000,1,1,2,0.5,0.5
2004_YEM,YEM,2004,3,0,3,1,0
2008_YEM,YEM,2008,4,1,5,0.8,0.2
2012_YEM,YEM,2012,3,1,4,0.75,0.25
2016_YEM,YEM,2016,2,1,3,0.667,0.333
1988_YMD,YMD,1988,5,0,5,1,0
1920_YUG,YUG,1920,15,0,15,1,0
1924_YUG,YUG,1924,46,0,46,1,0
1928_YUG,YUG,1928,40,0,40,1,0
1932_YUG,YUG,1932,1,0,1,1,0
1936_YUG,YUG,1936,95,15,110,0.864,0.136
1948_YUG,YUG,1948,96,11,107,0.897,0.103
1952_YUG,YUG,1952,81,12,93,0.871,0.129
1956_YUG,YUG,1956,44,8,52,0.846,0.154
1960_YUG,YUG,1960,107,9,116,0.922,0.078
1964_YUG,YUG,1964,101,5,106,0.953,0.047
1968_YUG,YUG,1968,88,11,99,0.889,0.111
1972_YUG,YUG,1972,139,13,152,0.914,0.086
1976_YUG,YUG,1976,110,6,116,0.948,0.052
1980_YUG,YUG,1980,147,32,179,0.821,0.179
1984_YUG,YUG,1984,164,47,211,0.777,0.223
1988_YUG,YUG,1988,133,44,177,0.751,0.249
1992_YUG,YUG,1992,22,3,25,0.88,0.12
1964_ZAM,ZAM,1964,11,1,12,0.917,0.083
1968_ZAM,ZAM,1968,7,0,7,1,0
1972_ZAM,ZAM,1972,8,3,11,0.727,0.273
1980_ZAM,ZAM,1980,37,0,37,1,0
1984_ZAM,ZAM,1984,16,0,16,1,0
1988_ZAM,ZAM,1988,29,0,29,1,0
1992_ZAM,ZAM,1992,8,1,9,0.889,0.111
1996_ZAM,ZAM,1996,7,1,8,0.875,0.125
2000_ZAM,ZAM,2000,6,2,8,0.75,0.25
2004_ZAM,ZAM,2004,4,2,6,0.667,0.333
2008_ZAM,ZAM,2008,6,2,8,0.75,0.25
2012_ZAM,ZAM,2012,5,2,7,0.714,0.286
2016_ZAM,ZAM,2016,5,2,7,0.714,0.286
1928_ZIM,ZIM,1928,2,0,2,1,0
1960_ZIM,ZIM,1960,0,4,4,0,1
1964_ZIM,ZIM,1964,25,4,29,0.862,0.138
1980_ZIM,ZIM,1980,23,19,42,0.548,0.452
1984_ZIM,ZIM,1984,12,3,15,0.8,0.2
1988_ZIM,ZIM,1988,23,6,29,0.793,0.207
1992_ZIM,ZIM,1992,10,9,19,0.526,0.474
1996_ZIM,ZIM,1996,12,1,13,0.923,0.077
2000_ZIM,ZIM,2000,11,5,16,0.688,0.313
2004_ZIM,ZIM,2004,9,3,12,0.75,0.25
2008_ZIM,ZIM,2008,8,5,13,0.615,0.385
2012_ZIM,ZIM,2012,4,3,7,0.571,0.429
2016_ZIM,ZIM,2016,9,21,30,0.3,0.7
2020_AFG,AFG,2020,8,2,10,0.8,0.2
2020_ALB,ALB,2020,12,6,18,0.667,0.333
2020_ALG,ALG,2020,50,26,76,0.658,0.342
2020_AND,AND,2020,2,2,4,0.5,0.5
2020_ANG,ANG,2020,8,32,40,0.2,0.8
2020_ANT,ANT,2020,6,6,12,0.5,0.5
2020_ARG,ARG,2020,254,116,370,0.686,0.314
2020_ARM,ARM,2020,28,6,34,0.824,0.176
2020_ARU,ARU,2020,4,2,6,0.667,0.333
2020_ASA,ASA,2020,10,2,12,0.833,0.167
2020_AUS,AUS,2020,444,514,958,0.463,0.537
2020_AUT,AUT,2020,72,74,146,0.493,0.507
2020_AZE,AZE,2020,56,32,88,0.636,0.364
2020_BAH,BAH,2020,12,18,30,0.4,0.6
2020_BAN,BAN,2020,8,4,12,0.667,0.333
2020_BAR,BAR,2020,8,8,16,0.5,0.5
2020_BDI,BDI,2020,6,6,12,0.5,0.5
2020_BEL,BEL,2020,138,109,247,0.559,0.441
2020_BEN,BEN,2020,8,6,14,0.571,0.429
2020_BER,BER,2020,2,2,4,0.5,0.5
2020_BHU,BHU,2020,4,4,8,0.5,0.5
2020_BIH,BIH,2020,8,6,14,0.571,0.429
2020_BIZ,BIZ,2020,4,2,6,0.667,0.333
2020_BLR,BLR,2020,90,116,206,0.437,0.563
2020_BOL,BOL,2020,6,4,10,0.6,0.4
2020_BOT,BOT,2020,16,10,26,0.615,0.385
2020_BRA,BRA,2020,328,292,620,0.529,0.471
2020_BRN,BRN,2020,50,14,64,0.781,0.219
2020_BRU,BRU,2020,4,0,4,1,0
2020_BUL,BUL,2020,28,56,84,0.333,0.667
2020_BUR,BUR,2020,10,4,14,0.714,0.286
2020_CAF,CAF,2020,2,2,4,0.5,0.5
2020_CAM,CAM,2020,4,2,6,0.667,0.333
2020_CAN,CAN,2020,296,460,756,0.392,0.608
2020_CAY,CAY,2020,4,6,10,0.4,0.6
2020_CGO,CGO,2020,2,4,6,0.333,0.667
2020_CHA,CHA,2020,2,4,6,0.333,0.667
2020_CHI,CHI,2020,40,62,102,0.392,0.608
2020_CHN,CHN,2020,250,570,820,0.305,0.695
2020_CIV,CIV,2020,40,12,52,0.769,0.231
2020_CMR,CMR,2020,10,14,24,0.417,0.583
2020_COD,COD,2020,6,6,12,0.5,0.5
2020_COK,COK,2020,6,6,12,0.5,0.5
2020_COL,COL,2020,90,44,134,0.672,0.328
2020_COM,COM,2020,4,2,6,0.667,0.333
2020_CPV,CPV,2020,6,6,12,0.5,0.5
2020_CRC,CRC,2020,10,16,26,0.385,0.615
2020_CRO,CRO,2020,80,40,120,0.667,0.333
2020_CUB,CUB,2020,70,64,134,0.522,0.478
2020_CYP,CYP,2020,18,12,30,0.6,0.4
2020_CZE,CZE,2020,140,78,218,0.642,0.358
2020_DEN,DEN,2020,110,98,208,0.529,0.471
2020_DJI,DJI,2020,6,2,8,0.75,0.25
2020_DMA,DMA,2020,2,2,4,0.5,0.5
2020_DOM,DOM,2020,84,46,130,0.646,0.354
2020_ECU,ECU,2020,34,58,92,0.37,0.63
2020_EGY,EGY,2020,178,96,274,0.65,0.35
2020_EOR,EOR,2020,38,20,58,0.655,0.345
2020_ERI,ERI,2020,16,10,26,0.615,0.385
2020_ESA,ESA,2020,6,4,10,0.6,0.4
2020_ESP,ESP,2020,380,276,656,0.579,0.421
2020_EST,EST,2020,38,28,66,0.576,0.424
2020_ETH,ETH,2020,34,38,72,0.472,0.528
2020_FIJ,FIJ,2020,32,32,64,0.5,0.5
2020_FIN,FIN,2020,44,46,90,0.489,0.511
2020_FRA,FRA,2020,425,336,761,0.558,0.442
2020_FSM,FSM,2020,4,2,6,0.667,0.333
2020_GAB,GAB,2020,6,4,10,0.6,0.4
2020_GAM,GAM,2020,6,2,8,0.75,0.25
2020_GBR,GBR,2020,356,394,750,0.475,0.525
2020_GBS,GBS,2020,6,2,8,0.75,0.25
2020_GEO,GEO,2020,56,10,66,0.848,0.152
2020_GEQ,GEQ,2020,4,2,6,0.667,0.333
2020_GER,GER,2020,469,318,787,0.596,0.404
2020_GHA,GHA,2020,20,4,24,0.833,0.167
2020_GRE,GRE,2020,90,60,150,0.6,0.4
2020_GRN,GRN,2020,8,4,12,0.667,0.333
2020_GUA,GUA,2020,28,20,48,0.583,0.417
2020_GUI,GUI,2020,4,4,8,0.5,0.5
2020_GUM,GUM,2020,4,6,10,0.4,0.6
2020_GUY,GUY,2020,6,8,14,0.429,0.571
2020_HAI,HAI,2020,4,8,12,0.333,0.667
2020_HKG,HKG,2020,34,52,86,0.395,0.605
2020_HON,HON,2020,42,4,46,0.913,0.087
2020_HUN,HUN,2020,162,182,344,0.471,0.529
2020_INA,INA,2020,32,24,56,0.571,0.429
2020_IND,IND,2020,134,106,240,0.558,0.442
2020_IRI,IRI,2020,110,20,130,0.846,0.154
2020_IRL,IRL,2020,126,114,240,0.525,0.475
2020_IRQ,IRQ,2020,4,2,6,0.667,0.333
2020_ISL,ISL,2020,6,2,8,0.75,0.25
2020_ISR,ISR,2020,110,68,178,0.618,0.382
2020_ISV,ISV,2020,6,2,8,0.75,0.25
2020_ITA,ITA,2020,378,356,734,0.515,0.485
2020_IVB,IVB,2020,2,4,6,0.333,0.667
2020_JAM,JAM,2020,48,60,108,0.444,0.556
2020_JOR,JOR,2020,20,8,28,0.714,0.286
2020_JPN,JPN,2020,628,572,1200,0.523,0.477
2020_KAZ,KAZ,2020,128,66,194,0.66,0.34
2020_KEN,KEN,2020,72,98,170,0.424,0.576
2020_KGZ,KGZ,2020,22,10,32,0.688,0.313
2020_KIR,KIR,2020,4,2,6,0.667,0.333
2020_KOR,KOR,2020,260,210,470,0.553,0.447
2020_KOS,KOS,2020,10,12,22,0.455,0.545
2020_KSA,KSA,2020,58,4,62,0.935,0.065
2020_KUW,KUW,2020,16,4,20,0.8,0.2
2020_LAO,LAO,2020,4,4,8,0.5,0.5
2020_LAT,LAT,2020,38,26,64,0.594,0.406
2020_LBA,LBA,2020,6,2,8,0.75,0.25
2020_LBN,LBN,2020,6,6,12,0.5,0.5
2020_LBR,LBR,2020,4,2,6,0.667,0.333
2020_LCA,LCA,2020,4,6,10,0.4,0.6
2020_LES,LES,2020,2,2,4,0.5,0.5
2020_LIE,LIE,2020,4,6,10,0.4,0.6
2020_LTU,LTU,2020,52,32,84,0.619,0.381
2020_LUX,LUX,2020,16,8,24,0.667,0.333
2020_MAD,MAD,2020,8,4,12,0.667,0.333
2020_MAR,MAR,2020,60,28,88,0.682,0.318
2020_MAS,MAS,2020,24,36,60,0.4,0.6
2020_MAW,MAW,2020,4,6,10,0.4,0.6
2020_MDA,MDA,2020,18,22,40,0.45,0.55
2020_MDV,MDV,2020,4,4,8,0.5,0.5
2020_MEX,MEX,2020,190,130,320,0.594,0.406
2020_MGL,MGL,2020,36,50,86,0.419,0.581
2020_MHL,MHL,2020,2,2,4,0.5,0.5
2020_MKD,MKD,2020,10,6,16,0.625,0.375
2020_MLI,MLI,2020,6,2,8,0.75,0.25
2020_MLT,MLT,2020,4,8,12,0.333,0.667
2020_MNE,MNE,2020,32,36,68,0.471,0.529
2020_MON,MON,2020,6,6,12,0.5,0.5
2020_MOZ,MOZ,2020,8,12,20,0.4,0.6
2020_MRI,MRI,2020,12,4,16,0.75,0.25
2020_MTN,MTN,2020,2,2,4,0.5,0.5
2020_MYA,MYA,2020,2,2,4,0.5,0.5
2020_NA,NA,2020,12109,10966,23075,0.525,0.475
2020_NAM,NAM,2020,10,12,22,0.455,0.545
2020_NCA,NCA,2020,8,8,16,0.5,0.5
2020_NED,NED,2020,225,311,536,0.42,0.58
2020_NEP,NEP,2020,2,8,10,0.2,0.8
2020_NGR,NGR,2020,48,58,106,0.453,0.547
2020_NIG,NIG,2020,8,6,14,0.571,0.429
2020_NOR,NOR,2020,118,68,186,0.634,0.366
2020_NRU,NRU,2020,2,2,4,0.5,0.5
2020_NZL,NZL,2020,226,204,430,0.526,0.474
2020_OMA,OMA,2020,8,2,10,0.8,0.2
2020_PAK,PAK,2020,14,6,20,0.7,0.3
2020_PAN,PAN,2020,8,12,20,0.4,0.6
2020_PAR,PAR,2020,6,10,16,0.375,0.625
2020_PER,PER,2020,38,32,70,0.543,0.457
2020_PHI,PHI,2020,18,20,38,0.474,0.526
2020_PLE,PLE,2020,6,4,10,0.6,0.4
2020_PLW,PLW,2020,4,2,6,0.667,0.333
2020_PNG,PNG,2020,8,8,16,0.5,0.5
2020_POL,POL,2020,216,196,412,0.524,0.476
2020_POR,POR,2020,112,72,184,0.609,0.391
2020_PUR,PUR,2020,26,48,74,0.351,0.649
2020_QAT,QAT,2020,26,4,30,0.867,0.133
2020_ROC,ROC,2020,294,375,669,0.439,0.561
2020_ROU,ROU,2020,114,90,204,0.559,0.441
2020_RSA,RSA,2020,230,124,354,0.65,0.35
2020_RWA,RWA,2020,6,4,10,0.6,0.4
2020_SAM,SAM,2020,14,2,16,0.875,0.125
2020_SEN,SEN,2020,12,6,18,0.667,0.333
2020_SEY,SEY,2020,8,2,10,0.8,0.2
2020_SGP,SGP,2020,12,34,46,0.261,0.739
2020_SKN,SKN,2020,2,2,4,0.5,0.5
2020_SLE,SLE,2020,2,4,6,0.333,0.667
2020_SLO,SLO,2020,56,50,106,0.528,0.472
2020_SMR,SMR,2020,6,4,10,0.6,0.4
2020_SOL,SOL,2020,2,4,6,0.333,0.667
2020_SOM,SOM,2020,2,2,4,0.5,0.5
2020_SRB,SRB,2020,86,88,174,0.494,0.506
2020_SRI,SRI,2020,8,10,18,0.444,0.556
2020_SSD,SSD,2020,2,2,4,0.5,0.5
2020_STP,STP,2020,4,2,6,0.667,0.333
2020_SUD,SUD,2020,4,4,8,0.5,0.5
2020_SUI,SUI,2020,118,108,226,0.522,0.478
2020_SUR,SUR,2020,4,0,4,1,0
2020_SVK,SVK,2020,54,28,82,0.659,0.341
2020_SWE,SWE,2020,110,156,266,0.414,0.586
2020_SWZ,SWZ,2020,6,2,8,0.75,0.25
2020_SYR,SYR,2020,10,2,12,0.833,0.167
2020_TAN,TAN,2020,4,2,6,0.667,0.333
2020_TGA,TGA,2020,6,6,12,0.5,0.5
2020_THA,THA,2020,30,52,82,0.366,0.634
2020_TJK,TJK,2020,18,2,20,0.9,0.1
2020_TKM,TKM,2020,10,8,18,0.556,0.444
2020_TLS,TLS,2020,4,2,6,0.667,0.333
2020_TOG,TOG,2020,6,2,8,0.75,0.25
2020_TPE,TPE,2020,66,70,136,0.485,0.515
2020_TTO,TTO,2020,30,20,50,0.6,0.4
2020_TUN,TUN,2020,68,58,126,0.54,0.46
2020_TUR,TUR,2020,112,98,210,0.533,0.467
2020_TUV,TUV,2020,2,2,4,0.5,0.5
2020_UAE,UAE,2020,10,0,10,1,0
2020_UGA,UGA,2020,24,26,50,0.48,0.52
2020_UKR,UKR,2020,128,170,298,0.43,0.57
2020_URU,URU,2020,12,10,22,0.545,0.455
2020_USA,USA,2020,570,673,1243,0.459,0.541
2020_UZB,UZB,2020,74,60,134,0.552,0.448
2020_VAN,VAN,2020,6,0,6,1,0
2020_VEN,VEN,2020,60,26,86,0.698,0.302
2020_VIE,VIE,2020,16,20,36,0.444,0.556
2020_VIN,VIN,2020,2,4,6,0.333,0.667
2020_YEM,YEM,2020,6,4,10,0.6,0.4
2020_ZAM,ZAM,2020,12,42,54,0.222,0.778
2020_ZIM,ZIM,2020,8,2,10,0.8,0.2
