Year,Region,rank,whole_name,total_gold_medals,total_silver_medals,total_bronze_medals,total_medals,country_host
1896,USA,1,United States,11,7,2,20,0
1896,GRE,2,Greece,10,18,19,47,1
1896,GER,3,Germany,6,5,2,13,0
1896,GER,3,Germany,6,5,2,13,0
1896,GER,3,Germany,6,5,2,13,0
1896,FRA,4,France,5,4,2,11,0
1896,GBR,5,Great Britain,2,3,2,7,0
1896,HUN,6,Hungary,2,1,3,6,0
1896,AUT,7,Austria,2,1,2,5,0
1896,AUS,8,Australia,2,0,0,2,0
1896,DEN,9,Denmark,1,2,3,6,0
1896,SUI,10,Switzerland,1,2,0,3,0
1900,FRA,1,France,31,41,40,112,1
1900,USA,2,United States,20,13,15,48,0
1900,GBR,3,Great Britain,20,8,9,37,0
1900,BEL,4,Belgium,6,6,6,18,0
1900,SUI,5,Switzerland,6,3,1,10,0
1900,GER,6,Germany,4,3,2,9,0
1900,GER,6,Germany,4,3,2,9,0
1900,GER,6,Germany,4,3,2,9,0
1900,ITA,7,Italy,3,2,0,5,0
1900,DEN,8,Denmark,1,3,2,6,0
1900,NED,9,Netherlands,1,2,3,6,0
1900,HUN,11,Hungary,1,2,2,5,0
1900,CUB,12,Cuba,1,1,0,2,0
1900,ESP,13,Spain,1,0,0,1,0
1900,AUT,14,Austria,0,3,3,6,0
1900,NOR,15,Norway,0,2,3,5,0
1900,IND,16,India,0,2,0,2,0
1900,CZE,17,Bohemia,0,1,1,2,0
1900,AUS,18,Australia,0,0,3,3,0
1900,SWE,19,Sweden,0,0,1,1,0
1904,USA,1,United States,77,79,78,234,1
1904,GER,2,Germany,4,5,6,15,0
1904,GER,2,Germany,4,5,6,15,0
1904,GER,2,Germany,4,5,6,15,0
1904,CAN,3,Canada,4,1,1,6,0
1904,CUB,4,Cuba,3,0,0,3,0
1904,HUN,5,Hungary,2,1,1,4,0
1904,NOR,6,Norway,2,0,0,2,0
1904,AUT,7,Austria,1,1,1,3,0
1904,GBR,8,Great Britain,1,1,0,2,0
1904,SUI,9,Switzerland,1,0,2,3,0
1904,GRE,10,Greece,1,0,1,2,0
1904,AUS,12,Australia,0,3,1,4,0
1904,FRA,13,France,0,1,0,1,0
1908,GBR,1,Great Britain,56,51,39,146,0
1908,USA,2,United States,23,12,12,47,0
1908,SWE,3,Sweden,8,6,11,25,0
1908,FRA,4,France,5,5,9,19,0
1908,GER,5,Germany,3,5,5,13,0
1908,GER,5,Germany,3,5,5,13,0
1908,GER,5,Germany,3,5,5,13,0
1908,HUN,6,Hungary,3,4,2,9,0
1908,CAN,7,Canada,3,3,10,16,0
1908,NOR,8,Norway,2,3,3,8,0
1908,ITA,9,Italy,2,2,0,4,0
1908,BEL,10,Belgium,1,5,2,8,0
1908,AUS,11,Australasia,1,2,2,5,0
1908,RUS,12,Russian Empire,1,2,0,3,0
1908,FIN,13,Finland,1,1,3,5,0
1908,RSA,14,South Africa,1,1,0,2,0
1908,GRE,15,Greece,0,3,1,4,0
1908,DEN,16,Denmark,0,2,3,5,0
1908,CZE,17,Bohemia,0,0,2,2,0
1908,NED,17,Netherlands,0,0,2,2,0
1908,AUT,19,Austria,0,0,1,1,0
1912,USA,1,United States,26,19,19,64,0
1912,SWE,2,Sweden,23,25,17,65,1
1912,GBR,3,Great Britain,10,15,16,41,0
1912,FIN,4,Finland,9,8,9,26,0
1912,FRA,5,France,7,4,3,14,0
1912,GER,6,Germany,5,13,7,25,0
1912,GER,6,Germany,5,13,7,25,0
1912,GER,6,Germany,5,13,7,25,0
1912,RSA,7,South Africa,4,2,0,6,0
1912,NOR,8,Norway,3,2,5,10,0
1912,CAN,9,Canada,3,2,3,8,0
1912,HUN,9,Hungary,3,2,3,8,0
1912,ITA,11,Italy,3,1,2,6,0
1912,AUS,12,Australasia,2,2,3,7,0
1912,BEL,13,Belgium,2,1,3,6,0
1912,DEN,14,Denmark,1,6,5,12,0
1912,GRE,15,Greece,1,0,1,2,0
1912,RUS,16,Russian Empire,0,2,3,5,0
1912,AUT,17,Austria,0,2,2,4,0
1912,NED,18,Netherlands,0,0,3,3,0
1920,USA,1,United States,41,27,27,95,0
1920,SWE,2,Sweden,19,20,25,64,0
1920,FIN,3,Finland,15,10,9,34,0
1920,GBR,4,Great Britain,14,15,13,42,0
1920,BEL,5,Belgium,14,11,11,36,1
1920,NOR,6,Norway,13,9,9,31,0
1920,ITA,7,Italy,13,5,5,23,0
1920,FRA,8,France,9,19,13,41,0
1920,NED,9,Netherlands,4,2,5,11,0
1920,DEN,10,Denmark,3,9,1,13,0
1920,RSA,11,South Africa,3,4,3,10,0
1920,CAN,12,Canada,3,3,3,9,0
1920,SUI,13,Switzerland,2,2,7,11,0
1920,EST,14,Estonia,1,2,0,3,0
1920,BRA,15,Brazil,1,1,1,3,0
1920,AUS,16,Australia,0,2,1,3,0
1920,JPN,17,Japan,0,2,0,2,0
1920,ESP,17,Spain,0,2,0,2,0
1920,GRE,19,Greece,0,1,0,1,0
1920,LUX,19,Luxembourg,0,1,0,1,0
1920,CZE,21,Czechoslovakia,0,0,2,2,0
1920,NZL,22,New Zealand,0,0,1,1,0
1924,USA,1,United States,45,27,27,99,0
1924,FIN,2,Finland,14,13,10,37,0
1924,FRA,3,France,13,15,10,38,1
1924,GBR,4,Great Britain,9,13,12,34,0
1924,ITA,5,Italy,8,3,5,16,0
1924,SUI,6,Switzerland,7,8,10,25,0
1924,NOR,7,Norway,5,2,3,10,0
1924,SWE,8,Sweden,4,13,12,29,0
1924,NED,9,Netherlands,4,1,5,10,0
1924,BEL,10,Belgium,3,7,3,13,0
1924,AUS,11,Australia,3,1,2,6,0
1924,DEN,12,Denmark,2,5,2,9,0
1924,HUN,13,Hungary,2,3,4,9,0
1924,SRB,14,Yugoslavia,2,0,0,2,0
1924,CZE,15,Czechoslovakia,1,4,5,10,0
1924,ARG,16,Argentina,1,3,2,6,0
1924,EST,17,Estonia,1,1,4,6,0
1924,RSA,18,South Africa,1,1,1,3,0
1924,URU,19,Uruguay,1,0,0,1,0
1924,AUT,20,Austria,0,3,1,4,0
1924,CAN,20,Canada,0,3,1,4,0
1924,POL,22,Poland,0,1,1,2,0
1924,HAI,23,Haiti,0,0,1,1,0
1924,JPN,23,Japan,0,0,1,1,0
1924,NZL,23,New Zealand,0,0,1,1,0
1924,POR,23,Portugal,0,0,1,1,0
1924,ROU,23,Romania,0,0,1,1,0
1928,USA,1,United States,22,18,16,56,0
1928,GER,2,Germany,10,7,14,31,0
1928,GER,2,Germany,10,7,14,31,0
1928,GER,2,Germany,10,7,14,31,0
1928,FIN,3,Finland,8,8,9,25,0
1928,SWE,4,Sweden,7,6,12,25,0
1928,ITA,5,Italy,7,5,7,19,0
1928,SUI,6,Switzerland,7,4,4,15,0
1928,FRA,7,France,6,10,5,21,0
1928,NED,8,Netherlands,6,9,4,19,1
1928,HUN,9,Hungary,4,5,0,9,0
1928,CAN,10,Canada,4,4,7,15,0
1928,GBR,11,Great Britain,3,10,7,20,0
1928,ARG,12,Argentina,3,3,1,7,0
1928,DEN,13,Denmark,3,1,2,6,0
1928,CZE,14,Czechoslovakia,2,5,2,9,0
1928,JPN,15,Japan,2,2,1,5,0
1928,EST,16,Estonia,2,1,2,5,0
1928,EGY,17,Egypt,2,1,1,4,0
1928,AUT,18,Austria,2,0,1,3,0
1928,AUS,19,Australia,1,2,1,4,0
1928,NOR,19,Norway,1,2,1,4,0
1928,POL,21,Poland,1,1,3,5,0
1928,SRB,21,Yugoslavia,1,1,3,5,0
1928,RSA,23,South Africa,1,0,2,3,0
1928,IND,24,India,1,0,0,1,0
1928,IRL,24,Ireland,1,0,0,1,0
1928,NZL,24,New Zealand,1,0,0,1,0
1928,ESP,24,Spain,1,0,0,1,0
1928,URU,24,Uruguay,1,0,0,1,0
1928,BEL,29,Belgium,0,1,2,3,0
1928,CHI,30,Chile,0,1,0,1,0
1928,HAI,30,Haiti,0,1,0,1,0
1928,PHI,32,Philippines,0,0,1,1,0
1928,POR,32,Portugal,0,0,1,1,0
1936,GER,1,Germany,38,31,32,101,1
1936,GER,1,Germany,38,31,32,101,1
1936,GER,1,Germany,38,31,32,101,1
1936,USA,2,United States,24,21,12,57,0
1936,HUN,3,Hungary,10,1,5,16,0
1936,ITA,4,Italy,9,13,5,27,0
1936,FIN,5,Finland,8,6,6,20,0
1936,FRA,6,France,7,6,6,19,0
1936,SWE,7,Sweden,6,5,10,21,0
1936,JPN,8,Japan,6,4,10,20,0
1936,NED,9,Netherlands,6,4,7,17,0
1936,AUT,10,Austria,5,7,5,17,0
1936,SUI,11,Switzerland,4,9,5,18,0
1936,GBR,12,Great Britain,4,7,3,14,0
1936,CZE,13,Czechoslovakia,3,5,1,9,0
1936,ARG,14,Argentina,2,2,3,7,0
1936,EST,14,Estonia,2,2,3,7,0
1936,EGY,16,Egypt,2,1,2,5,0
1936,CAN,17,Canada,1,3,5,9,0
1936,NOR,18,Norway,1,3,2,6,0
1936,TUR,19,Turkey,1,0,1,2,0
1936,IND,20,India,1,0,0,1,0
1936,NZL,20,New Zealand,1,0,0,1,0
1936,POL,22,Poland,0,4,5,9,0
1936,DEN,23,Denmark,0,2,3,5,0
1936,LAT,24,Latvia,0,1,1,2,0
1936,ROU,25,Romania,0,1,0,1,0
1936,RSA,25,South Africa,0,1,0,1,0
1936,SRB,25,Yugoslavia,0,1,0,1,0
1936,BEL,28,Belgium,0,0,3,3,0
1936,MEX,28,Mexico,0,0,3,3,0
1936,AUS,30,Australia,0,0,1,1,0
1936,PHI,30,Philippines,0,0,1,1,0
1936,POR,30,Portugal,0,0,1,1,0
1948,USA,1,United States,38,27,19,84,0
1948,SWE,2,Sweden,17,11,18,46,0
1948,FRA,3,France,11,6,15,32,0
1948,FIN,4,Finland,10,8,6,24,0
1948,HUN,5,Hungary,10,5,13,28,0
1948,ITA,6,Italy,9,12,10,31,0
1948,TUR,7,Turkey,6,4,2,12,0
1948,CZE,8,Czechoslovakia,6,2,3,11,0
1948,SUI,9,Switzerland,5,12,6,23,1
1948,DEN,10,Denmark,5,8,9,22,0
1948,NED,11,Netherlands,5,2,9,16,0
1948,GBR,12,Great Britain,4,16,7,27,0
1948,ARG,13,Argentina,3,3,1,7,0
1948,AUS,14,Australia,2,6,5,13,0
1948,BEL,15,Belgium,2,2,3,7,0
1948,RSA,16,South Africa,2,2,2,6,0
1948,EGY,17,Egypt,2,2,1,5,0
1948,MEX,18,Mexico,2,1,2,5,0
1948,NOR,19,Norway,1,3,3,7,0
1948,JAM,20,Jamaica,1,2,0,3,0
1948,AUT,21,Austria,1,0,3,4,0
1948,POL,22,Poland,1,0,1,2,0
1948,IND,23,India,1,0,0,1,0
1948,PER,23,Peru,1,0,0,1,0
1948,CAN,25,Canada,0,2,2,4,0
1948,SRB,26,Yugoslavia,0,2,0,2,0
1948,POR,27,Portugal,0,1,1,2,0
1948,URU,27,Uruguay,0,1,1,2,0
1948,SRI,29,Ceylon,0,1,0,1,0
1948,CUB,29,Cuba,0,1,0,1,0
1948,ESP,29,Spain,0,1,0,1,0
1948,TTO,29,Trinidad and Tobago,0,1,0,1,0
1948,PAN,33,Panama,0,0,2,2,0
1948,KOR,33,South Korea,0,0,2,2,0
1948,BRA,35,Brazil,0,0,1,1,0
1948,IRI,35,Iran,0,0,1,1,0
1948,IRL,35,Ireland,0,0,1,1,0
1948,PUR,35,Puerto Rico,0,0,1,1,0
1952,USA,1,United States,40,19,17,76,0
1952,RUS,2,Soviet Union,22,30,19,71,0
1952,HUN,3,Hungary,16,10,16,42,0
1952,SWE,4,Sweden,12,13,10,35,0
1952,ITA,5,Italy,8,9,4,21,0
1952,CZE,6,Czechoslovakia,7,3,3,13,0
1952,FRA,7,France,6,6,6,18,0
1952,FIN,8,Finland,6,3,13,22,1
1952,AUS,9,Australia,6,2,3,11,0
1952,NOR,10,Norway,3,2,0,5,0
1952,SUI,11,Switzerland,2,6,6,14,0
1952,RSA,12,South Africa,2,4,4,10,0
1952,JAM,13,Jamaica,2,3,0,5,0
1952,BEL,14,Belgium,2,2,0,4,0
1952,DEN,15,Denmark,2,1,3,6,0
1952,TUR,16,Turkey,2,0,1,3,0
1952,JPN,17,Japan,1,6,2,9,0
1952,GBR,18,Great Britain,1,2,8,11,0
1952,ARG,19,Argentina,1,2,2,5,0
1952,POL,20,Poland,1,2,1,4,0
1952,CAN,21,Canada,1,2,0,3,0
1952,SRB,21,Yugoslavia,1,2,0,3,0
1952,ROU,23,Romania,1,1,2,4,0
1952,BRA,24,Brazil,1,0,2,3,0
1952,NZL,24,New Zealand,1,0,2,3,0
1952,IND,26,India,1,0,1,2,0
1952,LUX,27,Luxembourg,1,0,0,1,0
1952,GER,28,Germany,0,7,17,24,0
1952,GER,28,Germany,0,7,17,24,0
1952,GER,28,Germany,0,7,17,24,0
1952,NED,29,Netherlands,0,5,0,5,0
1952,IRI,30,Iran,0,3,4,7,0
1952,CHI,31,Chile,0,2,0,2,0
1952,AUT,32,Austria,0,1,1,2,0
1952,LIB,32,Lebanon,0,1,1,2,0
1952,IRL,34,Ireland,0,1,0,1,0
1952,MEX,34,Mexico,0,1,0,1,0
1952,ESP,34,Spain,0,1,0,1,0
1952,KOR,37,South Korea,0,0,2,2,0
1952,TTO,37,Trinidad and Tobago,0,0,2,2,0
1952,URU,37,Uruguay,0,0,2,2,0
1952,BUL,40,Bulgaria,0,0,1,1,0
1952,EGY,40,Egypt,0,0,1,1,0
1952,POR,40,Portugal,0,0,1,1,0
1952,VEN,40,Venezuela,0,0,1,1,0
1956,RUS,1,Soviet Union,37,29,32,98,0
1956,USA,2,United States,32,25,17,74,0
1956,AUS,3,Australia,13,8,14,35,0
1956,HUN,4,Hungary,9,10,7,26,0
1956,ITA,5,Italy,8,8,9,25,1
1956,SWE,6,Sweden,8,5,6,19,0
1956,GER,7,United Team of Germany,6,13,7,26,0
1956,GBR,8,Great Britain,6,7,11,24,0
1956,ROU,9,Romania,5,3,5,13,0
1956,JPN,10,Japan,4,10,5,19,0
1956,FRA,11,France,4,4,6,14,0
1956,TUR,12,Turkey,3,2,2,7,0
1956,FIN,13,Finland,3,1,11,15,0
1956,IRI,14,Iran,2,2,1,5,0
1956,CAN,15,Canada,2,1,3,6,0
1956,NZL,16,New Zealand,2,0,0,2,0
1956,POL,17,Poland,1,4,4,9,0
1956,CZE,18,Czechoslovakia,1,4,1,6,0
1956,BUL,19,Bulgaria,1,3,1,5,0
1956,DEN,20,Denmark,1,2,1,4,0
1956,IRL,21,Ireland,1,1,3,5,0
1956,NOR,22,Norway,1,0,2,3,0
1956,MEX,23,Mexico,1,0,1,2,0
1956,BRA,24,Brazil,1,0,0,1,0
1956,IND,24,India,1,0,0,1,0
1956,SRB,26,Yugoslavia,0,3,0,3,0
1956,CHI,27,Chile,0,2,2,4,0
1956,BEL,28,Belgium,0,2,0,2,0
1956,ARG,29,Argentina,0,1,1,2,0
1956,KOR,29,South Korea,0,1,1,2,0
1956,ISL,31,Iceland,0,1,0,1,0
1956,PAK,31,Pakistan,0,1,0,1,0
1956,RSA,33,South Africa,0,0,4,4,0
1956,AUT,34,Austria,0,0,2,2,0
1956,BAH,35,Bahamas,0,0,1,1,0
1956,GRE,35,Greece,0,0,1,1,0
1956,SUI,35,Switzerland,0,0,1,1,0
1956,URU,35,Uruguay,0,0,1,1,0
1964,USA,1,United States,36,26,28,90,0
1964,RUS,2,Soviet Union,30,31,35,96,0
1964,JPN,3,Japan,16,5,8,29,0
1964,GER,4,United Team of Germany,10,22,18,50,0
1964,ITA,5,Italy,10,10,7,27,0
1964,HUN,6,Hungary,10,7,5,22,0
1964,POL,7,Poland,7,6,10,23,0
1964,AUS,8,Australia,6,2,10,18,0
1964,CZE,9,Czechoslovakia,5,6,3,14,0
1964,GBR,10,Great Britain,4,12,2,18,0
1964,BUL,11,Bulgaria,3,5,2,10,0
1964,FIN,12,Finland,3,0,2,5,0
1964,NZL,12,New Zealand,3,0,2,5,0
1964,ROU,14,Romania,2,4,6,12,0
1964,NED,15,Netherlands,2,4,4,10,0
1964,TUR,16,Turkey,2,3,1,6,0
1964,SWE,17,Sweden,2,2,4,8,0
1964,DEN,18,Denmark,2,1,3,6,0
1964,SRB,19,Yugoslavia,2,1,2,5,0
1964,BEL,20,Belgium,2,0,1,3,0
1964,FRA,21,France,1,8,6,15,0
1964,CAN,22,Canada,1,2,1,4,0
1964,SUI,22,Switzerland,1,2,1,4,0
1964,BAH,24,Bahamas,1,0,0,1,0
1964,ETH,24,Ethiopia,1,0,0,1,0
1964,IND,24,India,1,0,0,1,0
1964,KOR,27,South Korea,0,2,1,3,0
1964,TTO,28,Trinidad and Tobago,0,1,2,3,0
1964,TUN,29,Tunisia,0,1,1,2,0
1964,ARG,30,Argentina,0,1,0,1,0
1964,CUB,30,Cuba,0,1,0,1,0
1964,PAK,30,Pakistan,0,1,0,1,0
1964,PHI,30,Philippines,0,1,0,1,0
1964,IRI,34,Iran,0,0,2,2,0
1964,BRA,35,Brazil,0,0,1,1,0
1964,GHA,35,Ghana,0,0,1,1,0
1964,IRL,35,Ireland,0,0,1,1,0
1964,KEN,35,Kenya,0,0,1,1,0
1964,MEX,35,Mexico,0,0,1,1,0
1964,NGR,35,Nigeria,0,0,1,1,0
1964,URU,35,Uruguay,0,0,1,1,0
1968,USA,1,United States,45,28,34,107,0
1968,RUS,2,Soviet Union,29,32,30,91,0
1968,JPN,3,Japan,11,7,7,25,0
1968,HUN,4,Hungary,10,10,12,32,0
1968,GER,5,East Germany,9,9,7,25,0
1968,FRA,6,France,7,3,5,15,0
1968,CZE,7,Czechoslovakia,7,2,4,13,0
1968,GER,8,West Germany,5,11,10,26,0
1968,AUS,9,Australia,5,7,5,17,0
1968,GBR,10,Great Britain,5,5,3,13,0
1968,POL,11,Poland,5,2,11,18,0
1968,ROU,12,Romania,4,6,5,15,0
1968,ITA,13,Italy,3,4,9,16,0
1968,KEN,14,Kenya,3,4,2,9,0
1968,MEX,15,Mexico,3,3,3,9,0
1968,SRB,16,Yugoslavia,3,3,2,8,0
1968,NED,17,Netherlands,3,3,1,7,0
1968,BUL,18,Bulgaria,2,4,3,9,0
1968,IRI,19,Iran,2,1,2,5,0
1968,SWE,20,Sweden,2,1,1,4,0
1968,TUR,21,Turkey,2,0,0,2,0
1968,DEN,22,Denmark,1,4,3,8,0
1968,CAN,23,Canada,1,3,1,5,0
1968,FIN,24,Finland,1,2,1,4,0
1968,ETH,25,Ethiopia,1,1,0,2,0
1968,NOR,25,Norway,1,1,0,2,0
1968,NZL,27,New Zealand,1,0,2,3,0
1968,TUN,28,Tunisia,1,0,1,2,0
1968,PAK,29,Pakistan,1,0,0,1,0
1968,VEN,29,Venezuela,1,0,0,1,0
1968,CUB,31,Cuba,0,4,0,4,0
1968,AUT,32,Austria,0,2,2,4,0
1968,SUI,33,Switzerland,0,1,4,5,0
1968,MGL,34,Mongolia,0,1,3,4,0
1968,BRA,35,Brazil,0,1,2,3,0
1968,BEL,36,Belgium,0,1,1,2,0
1968,KOR,36,South Korea,0,1,1,2,0
1968,UGA,36,Uganda,0,1,1,2,0
1968,CMR,39,Cameroon,0,1,0,1,0
1968,JAM,39,Jamaica,0,1,0,1,0
1968,ARG,41,Argentina,0,0,2,2,0
1968,GRE,42,Greece,0,0,1,1,0
1968,IND,42,India,0,0,1,1,0
1968,TPE,42,Taiwan,0,0,1,1,0
1972,RUS,1,Soviet Union,50,27,22,99,0
1972,USA,2,United States,33,31,30,94,0
1972,GER,3,East Germany,20,23,23,66,0
1972,GER,4,West Germany,13,11,16,40,1
1972,JPN,5,Japan,13,8,8,29,1
1972,AUS,6,Australia,8,7,2,17,0
1972,POL,7,Poland,7,5,9,21,0
1972,HUN,8,Hungary,6,13,16,35,0
1972,BUL,9,Bulgaria,6,10,5,21,0
1972,ITA,10,Italy,5,3,10,18,0
1972,SWE,11,Sweden,4,6,6,16,0
1972,GBR,12,Great Britain,4,5,9,18,0
1972,ROU,13,Romania,3,6,7,16,0
1972,CUB,14,Cuba,3,1,4,8,0
1972,FIN,14,Finland,3,1,4,8,0
1972,NED,16,Netherlands,3,1,1,5,0
1972,FRA,17,France,2,4,7,13,0
1972,CZE,18,Czechoslovakia,2,4,2,8,0
1972,KEN,19,Kenya,2,3,4,9,0
1972,SRB,20,Yugoslavia,2,1,2,5,0
1972,NOR,21,Norway,2,1,1,4,0
1972,PRK,22,North Korea,1,1,3,5,0
1972,NZL,23,New Zealand,1,1,1,3,0
1972,UGA,24,Uganda,1,1,0,2,0
1972,DEN,25,Denmark,1,0,0,1,0
1972,SUI,26,Switzerland,0,3,0,3,0
1972,CAN,27,Canada,0,2,3,5,0
1972,IRI,28,Iran,0,2,1,3,0
1972,BEL,29,Belgium,0,2,0,2,0
1972,GRE,29,Greece,0,2,0,2,0
1972,AUT,31,Austria,0,1,2,3,0
1972,COL,31,Colombia,0,1,2,3,0
1972,ARG,33,Argentina,0,1,0,1,0
1972,LIB,33,Lebanon,0,1,0,1,0
1972,MEX,33,Mexico,0,1,0,1,0
1972,MGL,33,Mongolia,0,1,0,1,0
1972,PAK,33,Pakistan,0,1,0,1,0
1972,KOR,33,South Korea,0,1,0,1,0
1972,TUN,33,Tunisia,0,1,0,1,0
1972,TUR,33,Turkey,0,1,0,1,0
1972,BRA,41,Brazil,0,0,2,2,0
1972,ETH,41,Ethiopia,0,0,2,2,0
1972,GHA,43,Ghana,0,0,1,1,0
1972,IND,43,India,0,0,1,1,0
1972,JAM,43,Jamaica,0,0,1,1,0
1972,NIG,43,Niger,0,0,1,1,0
1972,NGR,43,Nigeria,0,0,1,1,0
1972,ESP,43,Spain,0,0,1,1,0
1976,RUS,1,Soviet Union,49,41,35,125,0
1976,GER,2,East Germany,40,25,25,90,0
1976,USA,3,United States,34,35,25,94,0
1976,GER,4,West Germany,10,12,17,39,0
1976,JPN,5,Japan,9,6,10,25,0
1976,POL,6,Poland,7,6,13,26,0
1976,BUL,7,Bulgaria,6,9,7,22,0
1976,CUB,8,Cuba,6,4,3,13,0
1976,ROU,9,Romania,4,9,14,27,0
1976,HUN,10,Hungary,4,5,13,22,0
1976,FIN,11,Finland,4,2,0,6,0
1976,SWE,12,Sweden,4,1,0,5,0
1976,GBR,13,Great Britain,3,5,5,13,0
1976,ITA,14,Italy,2,7,4,13,0
1976,FRA,15,France,2,3,4,9,0
1976,SRB,16,Yugoslavia,2,3,3,8,0
1976,CZE,17,Czechoslovakia,2,2,4,8,0
1976,NZL,18,New Zealand,2,1,1,4,0
1976,KOR,19,South Korea,1,1,4,6,0
1976,SUI,20,Switzerland,1,1,2,4,0
1976,JAM,21,Jamaica,1,1,0,2,0
1976,PRK,21,North Korea,1,1,0,2,0
1976,NOR,21,Norway,1,1,0,2,0
1976,DEN,24,Denmark,1,0,2,3,0
1976,MEX,25,Mexico,1,0,1,2,0
1976,TTO,26,Trinidad and Tobago,1,0,0,1,0
1976,CAN,27,Canada,0,5,6,11,0
1976,BEL,28,Belgium,0,3,3,6,0
1976,NED,29,Netherlands,0,2,3,5,0
1976,POR,30,Portugal,0,2,0,2,0
1976,ESP,30,Spain,0,2,0,2,0
1976,AUS,32,Australia,0,1,4,5,0
1976,IRI,33,Iran,0,1,1,2,0
1976,MGL,34,Mongolia,0,1,0,1,0
1976,VEN,34,Venezuela,0,1,0,1,0
1976,BRA,36,Brazil,0,0,2,2,0
1976,AUT,37,Austria,0,0,1,1,1
1976,BER,37,Bermuda,0,0,1,1,0
1976,PAK,37,Pakistan,0,0,1,1,0
1976,PUR,37,Puerto Rico,0,0,1,1,0
1976,THA,37,Thailand,0,0,1,1,0
1980,RUS,1,Soviet Union,80,69,46,195,0
1980,GER,2,East Germany,47,37,42,126,0
1980,BUL,3,Bulgaria,8,16,17,41,0
1980,CUB,4,Cuba,8,7,5,20,0
1980,ITA,5,Italy,8,3,4,15,0
1980,HUN,6,Hungary,7,10,15,32,0
1980,ROU,7,Romania,6,6,13,25,0
1980,FRA,8,France,6,5,3,14,0
1980,GBR,9,Great Britain,5,7,9,21,0
1980,POL,10,Poland,3,14,15,32,0
1980,SWE,11,Sweden,3,3,6,12,0
1980,FIN,12,Finland,3,1,4,8,0
1980,CZE,13,Czechoslovakia,2,3,9,14,0
1980,SRB,14,Yugoslavia,2,3,4,9,0
1980,AUS,15,Australia,2,2,5,9,0
1980,DEN,16,Denmark,2,1,2,5,0
1980,BRA,17,Brazil,2,0,2,4,0
1980,ETH,17,Ethiopia,2,0,2,4,0
1980,SUI,19,Switzerland,2,0,0,2,0
1980,ESP,20,Spain,1,3,2,6,0
1980,AUT,21,Austria,1,2,1,4,0
1980,GRE,22,Greece,1,0,2,3,0
1980,BEL,23,Belgium,1,0,0,1,0
1980,IND,23,India,1,0,0,1,0
1980,ZIM,23,Zimbabwe,1,0,0,1,0
1980,PRK,26,North Korea,0,3,2,5,0
1980,MGL,27,Mongolia,0,2,2,4,0
1980,TAN,28,Tanzania,0,2,0,2,0
1980,MEX,29,Mexico,0,1,3,4,0
1980,NED,30,Netherlands,0,1,2,3,0
1980,IRL,31,Ireland,0,1,1,2,0
1980,UGA,32,Uganda,0,1,0,1,0
1980,VEN,32,Venezuela,0,1,0,1,0
1980,JAM,34,Jamaica,0,0,3,3,0
1980,GUY,35,Guyana,0,0,1,1,0
1980,LIB,35,Lebanon,0,0,1,1,0
1984,USA,1,United States,83,61,30,174,0
1984,ROU,2,Romania,20,16,17,53,0
1984,GER,3,West Germany,17,19,23,59,0
1984,CHN,4,China,15,8,9,32,0
1984,ITA,5,Italy,14,6,12,32,0
1984,CAN,6,Canada,10,18,16,44,0
1984,JPN,7,Japan,10,8,14,32,0
1984,NZL,8,New Zealand,8,1,2,11,0
1984,SRB,9,Yugoslavia,7,4,7,18,1
1984,KOR,10,South Korea,6,6,7,19,0
1984,GBR,11,Great Britain,5,11,21,37,0
1984,FRA,12,France,5,7,16,28,0
1984,NED,13,Netherlands,5,2,6,13,0
1984,AUS,14,Australia,4,8,12,24,0
1984,FIN,15,Finland,4,2,6,12,0
1984,SWE,16,Sweden,2,11,6,19,0
1984,MEX,17,Mexico,2,3,1,6,0
1984,MAR,18,Morocco,2,0,0,2,0
1984,BRA,19,Brazil,1,5,2,8,0
1984,ESP,20,Spain,1,2,2,5,0
1984,BEL,21,Belgium,1,1,2,4,0
1984,AUT,22,Austria,1,1,1,3,0
1984,KEN,23,Kenya,1,0,2,3,0
1984,POR,23,Portugal,1,0,2,3,0
1984,PAK,25,Pakistan,1,0,0,1,0
1984,SUI,26,Switzerland,0,4,4,8,0
1984,DEN,27,Denmark,0,3,3,6,0
1984,JAM,28,Jamaica,0,1,2,3,0
1984,NOR,28,Norway,0,1,2,3,0
1984,GRE,30,Greece,0,1,1,2,0
1984,NGR,30,Nigeria,0,1,1,2,0
1984,PUR,30,Puerto Rico,0,1,1,2,0
1984,COL,33,Colombia,0,1,0,1,0
1984,EGY,33,Egypt,0,1,0,1,0
1984,IRL,33,Ireland,0,1,0,1,0
1984,CIV,33,Ivory Coast,0,1,0,1,0
1984,PER,33,Peru,0,1,0,1,0
1984,SYR,33,Syria,0,1,0,1,0
1984,UAR,33,Syria,0,1,0,1,0
1984,THA,33,Thailand,0,1,0,1,0
1984,TUR,40,Turkey,0,0,3,3,0
1984,VEN,40,Venezuela,0,0,3,3,0
1984,ALG,42,Algeria,0,0,2,2,0
1984,CMR,43,Cameroon,0,0,1,1,0
1984,NA,43,Chinese Taipei,0,0,1,1,0
1984,DOM,43,Dominican Republic,0,0,1,1,0
1984,ISL,43,Iceland,0,0,1,1,0
1984,ZAM,43,Zambia,0,0,1,1,0
1988,RUS,1,Soviet Union,55,31,46,132,0
1988,GER,2,East Germany,37,35,30,102,0
1988,USA,3,United States,36,31,27,94,0
1988,KOR,4,South Korea,12,10,11,33,1
1988,GER,5,West Germany,11,14,15,40,0
1988,HUN,6,Hungary,11,6,6,23,0
1988,BUL,7,Bulgaria,10,12,13,35,0
1988,ROU,8,Romania,7,11,6,24,0
1988,FRA,9,France,6,4,6,16,0
1988,ITA,10,Italy,6,4,4,14,0
1988,CHN,11,China,5,11,12,28,0
1988,GBR,12,Great Britain,5,10,9,24,0
1988,KEN,13,Kenya,5,2,2,9,0
1988,JPN,14,Japan,4,3,7,14,0
1988,AUS,15,Australia,3,6,5,14,0
1988,SRB,16,Yugoslavia,3,4,5,12,0
1988,CZE,17,Czechoslovakia,3,3,2,8,0
1988,NZL,18,New Zealand,3,2,8,13,0
1988,CAN,19,Canada,3,2,5,10,1
1988,POL,20,Poland,2,5,9,16,0
1988,NOR,21,Norway,2,3,0,5,0
1988,NED,22,Netherlands,2,2,5,9,0
1988,DEN,23,Denmark,2,1,1,4,0
1988,BRA,24,Brazil,1,2,3,6,0
1988,FIN,25,Finland,1,1,2,4,0
1988,ESP,25,Spain,1,1,2,4,0
1988,TUR,27,Turkey,1,1,0,2,0
1988,MAR,28,Morocco,1,0,2,3,0
1988,AUT,29,Austria,1,0,0,1,0
1988,POR,29,Portugal,1,0,0,1,0
1988,SUR,29,Suriname,1,0,0,1,0
1988,SWE,32,Sweden,0,4,7,11,0
1988,SUI,33,Switzerland,0,2,2,4,0
1988,JAM,34,Jamaica,0,2,0,2,0
1988,ARG,35,Argentina,0,1,1,2,0
1988,CHI,36,Chile,0,1,0,1,0
1988,CRC,36,Costa Rica,0,1,0,1,0
1988,INA,36,Indonesia,0,1,0,1,0
1988,IRI,36,Iran,0,1,0,1,0
1988,AHO,36,Netherlands Antilles,0,1,0,1,0
1988,PER,36,Peru,0,1,0,1,0
1988,SEN,36,Senegal,0,1,0,1,0
1988,ISV,36,Virgin Islands,0,1,0,1,0
1988,BEL,44,Belgium,0,0,2,2,0
1988,MEX,44,Mexico,0,0,2,2,0
1988,COL,46,Colombia,0,0,1,1,0
1988,DJI,46,Djibouti,0,0,1,1,0
1988,GRE,46,Greece,0,0,1,1,0
1988,MGL,46,Mongolia,0,0,1,1,0
1988,PAK,46,Pakistan,0,0,1,1,0
1988,PHI,46,Philippines,0,0,1,1,0
1988,THA,46,Thailand,0,0,1,1,0
1992,NA,1,Unified Team,45,38,29,112,0
1992,USA,2,United States,37,34,37,108,0
1992,GER,3,Germany,33,21,28,82,0
1992,GER,3,Germany,33,21,28,82,0
1992,GER,3,Germany,33,21,28,82,0
1992,CHN,4,China,16,22,16,54,0
1992,CUB,5,Cuba,14,6,11,31,0
1992,ESP,6,Spain,13,7,2,22,1
1992,KOR,7,South Korea,12,5,12,29,0
1992,HUN,8,Hungary,11,12,7,30,0
1992,FRA,9,France,8,5,16,29,1
1992,AUS,10,Australia,7,9,11,27,0
1992,CAN,11,Canada,7,4,7,18,0
1992,ITA,12,Italy,6,5,8,19,0
1992,GBR,13,Great Britain,5,3,12,20,0
1992,ROU,14,Romania,4,6,8,18,0
1992,CZE,15,Czechoslovakia,4,2,1,7,0
1992,PRK,16,North Korea,4,0,5,9,0
1992,JPN,17,Japan,3,8,11,22,0
1992,BUL,18,Bulgaria,3,7,6,16,0
1992,POL,19,Poland,3,6,10,19,0
1992,NED,20,Netherlands,2,6,7,15,0
1992,KEN,21,Kenya,2,4,2,8,0
1992,NOR,22,Norway,2,4,1,7,0
1992,TUR,23,Turkey,2,2,2,6,0
1992,INA,24,Indonesia,2,2,1,5,0
1992,BRA,25,Brazil,2,1,0,3,0
1992,GRE,26,Greece,2,0,0,2,0
1992,SWE,27,Sweden,1,7,4,12,0
1992,NZL,28,New Zealand,1,4,5,10,0
1992,FIN,29,Finland,1,2,2,5,0
1992,DEN,30,Denmark,1,1,4,6,0
1992,MAR,31,Morocco,1,1,1,3,0
1992,IRL,32,Ireland,1,1,0,2,0
1992,ETH,33,Ethiopia,1,0,2,3,0
1992,ALG,34,Algeria,1,0,1,2,0
1992,EST,34,Estonia,1,0,1,2,0
1992,LTU,34,Lithuania,1,0,1,2,0
1992,SUI,37,Switzerland,1,0,0,1,0
1992,JAM,38,Jamaica,0,3,1,4,0
1992,NGR,38,Nigeria,0,3,1,4,0
1992,LAT,40,Latvia,0,2,1,3,0
1992,AUT,41,Austria,0,2,0,2,0
1992,NAM,41,Namibia,0,2,0,2,0
1992,RSA,41,South Africa,0,2,0,2,0
1992,BEL,44,Belgium,0,1,2,3,0
1992,CRO,44,Croatia,0,1,2,3,0
1992,NA,44,Independent Olympic Participants,0,1,2,3,0
1992,IRI,44,Iran,0,1,2,3,0
1992,ISR,48,Israel,0,1,1,2,0
1992,NA,49,Chinese Taipei,0,1,0,1,0
1992,MEX,49,Mexico,0,1,0,1,0
1992,PER,49,Peru,0,1,0,1,0
1992,MGL,52,Mongolia,0,0,2,2,0
1992,SLO,52,Slovenia,0,0,2,2,0
1992,ARG,54,Argentina,0,0,1,1,0
1992,BAH,54,Bahamas,0,0,1,1,0
1992,COL,54,Colombia,0,0,1,1,0
1992,GHA,54,Ghana,0,0,1,1,0
1992,MAS,54,Malaysia,0,0,1,1,0
1992,PAK,54,Pakistan,0,0,1,1,0
1992,PHI,54,Philippines,0,0,1,1,0
1992,PUR,54,Puerto Rico,0,0,1,1,0
1992,QAT,54,Qatar,0,0,1,1,0
1992,SUR,54,Suriname,0,0,1,1,0
1992,THA,54,Thailand,0,0,1,1,0
1996,USA,1,United States,44,32,25,101,1
1996,RUS,2,Russia,26,21,16,63,0
1996,RUS,2,Russia,26,21,16,63,0
1996,GER,3,Germany,20,18,27,65,0
1996,GER,3,Germany,20,18,27,65,0
1996,GER,3,Germany,20,18,27,65,0
1996,CHN,4,China,16,22,12,50,0
1996,FRA,5,France,15,7,15,37,0
1996,ITA,6,Italy,13,10,12,35,0
1996,AUS,7,Australia,9,9,23,41,0
1996,CUB,8,Cuba,9,8,8,25,0
1996,UKR,9,Ukraine,9,2,12,23,0
1996,KOR,10,South Korea,7,15,5,27,0
1996,POL,11,Poland,7,5,5,17,0
1996,HUN,12,Hungary,7,4,10,21,0
1996,ESP,13,Spain,5,6,6,17,0
1996,ROU,14,Romania,4,7,9,20,0
1996,NED,15,Netherlands,4,5,10,19,0
1996,GRE,16,Greece,4,4,0,8,0
1996,CZE,17,Czech Republic,4,3,4,11,0
1996,CZE,17,Czech Republic,4,3,4,11,0
1996,SUI,18,Switzerland,4,3,0,7,0
1996,DEN,19,Denmark,4,1,1,6,0
1996,TUR,19,Turkey,4,1,1,6,0
1996,CAN,21,Canada,3,11,8,22,0
1996,BUL,22,Bulgaria,3,7,5,15,0
1996,JPN,23,Japan,3,6,5,14,0
1996,KAZ,24,Kazakhstan,3,4,4,11,0
1996,BRA,25,Brazil,3,3,9,15,0
1996,NZL,26,New Zealand,3,2,1,6,0
1996,RSA,27,South Africa,3,1,1,5,0
1996,IRL,28,Ireland,3,0,1,4,0
1996,SWE,29,Sweden,2,4,2,8,0
1996,NOR,30,Norway,2,2,3,7,0
1996,BEL,31,Belgium,2,2,2,6,0
1996,NGR,32,Nigeria,2,1,3,6,0
1996,PRK,33,North Korea,2,1,2,5,0
1996,ALG,34,Algeria,2,0,1,3,0
1996,ETH,34,Ethiopia,2,0,1,3,0
1996,GBR,36,Great Britain,1,8,6,15,0
1996,BLR,37,Belarus,1,6,8,15,0
1996,KEN,38,Kenya,1,4,3,8,0
1996,JAM,39,Jamaica,1,3,2,6,0
1996,FIN,40,Finland,1,2,1,4,0
1996,NA,41,FR Yugoslavia,1,1,2,4,0
1996,INA,41,Indonesia,1,1,2,4,0
1996,IRI,43,Iran,1,1,1,3,0
1996,SVK,43,Slovakia,1,1,1,3,0
1996,ARM,45,Armenia,1,1,0,2,0
1996,CRO,45,Croatia,1,1,0,2,0
1996,POR,47,Portugal,1,0,1,2,0
1996,THA,47,Thailand,1,0,1,2,0
1996,BDI,49,Burundi,1,0,0,1,0
1996,CRC,49,Costa Rica,1,0,0,1,0
1996,ECU,49,Ecuador,1,0,0,1,0
1996,NA,49,Hong Kong,1,0,0,1,0
1996,SYR,49,Syria,1,0,0,1,0
1996,UAR,49,Syria,1,0,0,1,0
1996,ARG,54,Argentina,0,2,1,3,0
1996,NAM,55,Namibia,0,2,0,2,0
1996,SLO,55,Slovenia,0,2,0,2,0
1996,AUT,57,Austria,0,1,2,3,0
1996,MAS,58,Malaysia,0,1,1,2,0
1996,MDA,58,Moldova,0,1,1,2,0
1996,UZB,58,Uzbekistan,0,1,1,2,0
1996,AZE,61,Azerbaijan,0,1,0,1,0
1996,BAH,61,Bahamas,0,1,0,1,0
1996,NA,61,Chinese Taipei,0,1,0,1,0
1996,LAT,61,Latvia,0,1,0,1,0
1996,PHI,61,Philippines,0,1,0,1,0
1996,TGA,61,Tonga,0,1,0,1,0
1996,ZAM,61,Zambia,0,1,0,1,0
1996,GEO,68,Georgia,0,0,2,2,0
1996,MAR,68,Morocco,0,0,2,2,0
1996,TTO,68,Trinidad and Tobago,0,0,2,2,0
1996,IND,71,India,0,0,1,1,0
1996,ISR,71,Israel,0,0,1,1,0
1996,LTU,71,Lithuania,0,0,1,1,0
1996,MEX,71,Mexico,0,0,1,1,0
1996,MGL,71,Mongolia,0,0,1,1,0
1996,MOZ,71,Mozambique,0,0,1,1,0
1996,PUR,71,Puerto Rico,0,0,1,1,0
1996,TUN,71,Tunisia,0,0,1,1,0
1996,UGA,71,Uganda,0,0,1,1,0
2000,USA,1,United States,37,24,32,93,0
2000,RUS,2,Russia,32,28,29,89,0
2000,RUS,2,Russia,32,28,29,89,0
2000,CHN,3,China,28,16,14,58,0
2000,AUS,4,Australia,16,25,17,58,1
2000,GER,5,Germany,13,17,26,56,0
2000,GER,5,Germany,13,17,26,56,0
2000,GER,5,Germany,13,17,26,56,0
2000,FRA,6,France,13,14,11,38,0
2000,ITA,7,Italy,13,8,13,34,0
2000,NED,8,Netherlands,12,9,4,25,0
2000,CUB,9,Cuba,11,11,7,29,0
2000,GBR,10,Great Britain,11,10,7,28,0
2000,ROU,11,Romania,11,6,9,26,0
2000,KOR,12,South Korea,8,10,10,28,0
2000,HUN,13,Hungary,8,6,3,17,0
2000,POL,14,Poland,6,5,3,14,0
2000,JPN,15,Japan,5,8,5,18,0
2000,BUL,16,Bulgaria,5,6,2,13,0
2000,GRE,17,Greece,4,6,3,13,0
2000,SWE,18,Sweden,4,5,3,12,0
2000,NOR,19,Norway,4,3,3,10,0
2000,ETH,20,Ethiopia,4,1,3,8,0
2000,UKR,21,Ukraine,3,10,10,23,0
2000,KAZ,22,Kazakhstan,3,4,0,7,0
2000,BLR,23,Belarus,3,3,11,17,0
2000,CAN,24,Canada,3,3,8,14,0
2000,ESP,25,Spain,3,3,5,11,0
2000,TUR,26,Turkey,3,0,2,5,0
2000,IRI,27,Iran,3,0,1,4,0
2000,CZE,28,Czech Republic,2,3,3,8,0
2000,CZE,28,Czech Republic,2,3,3,8,0
2000,KEN,29,Kenya,2,3,2,7,0
2000,DEN,30,Denmark,2,3,1,6,0
2000,FIN,31,Finland,2,1,1,4,0
2000,AUT,32,Austria,2,1,0,3,0
2000,LTU,33,Lithuania,2,0,3,5,0
2000,AZE,34,Azerbaijan,2,0,1,3,0
2000,BAH,34,Bahamas,2,0,1,3,0
2000,SLO,36,Slovenia,2,0,0,2,0
2000,SUI,37,Switzerland,1,6,2,9,0
2000,INA,38,Indonesia,1,3,2,6,0
2000,SVK,39,Slovakia,1,3,1,5,0
2000,MEX,40,Mexico,1,2,3,6,0
2000,NGR,41,Nigeria,1,2,0,3,0
2000,ALG,42,Algeria,1,1,3,5,0
2000,UZB,43,Uzbekistan,1,1,2,4,0
2000,NA,44,FR Yugoslavia,1,1,1,3,0
2000,LAT,44,Latvia,1,1,1,3,0
2000,NZL,46,New Zealand,1,0,3,4,0
2000,EST,47,Estonia,1,0,2,3,0
2000,THA,47,Thailand,1,0,2,3,0
2000,CRO,49,Croatia,1,0,1,2,0
2000,CMR,50,Cameroon,1,0,0,1,0
2000,COL,50,Colombia,1,0,0,1,0
2000,MOZ,50,Mozambique,1,0,0,1,0
2000,BRA,53,Brazil,0,6,6,12,0
2000,JAM,54,Jamaica,0,6,3,9,0
2000,BEL,55,Belgium,0,2,3,5,0
2000,RSA,55,South Africa,0,2,3,5,0
2000,ARG,57,Argentina,0,2,2,4,0
2000,NA,58,Chinese Taipei,0,1,4,5,0
2000,MAR,58,Morocco,0,1,4,5,0
2000,PRK,60,North Korea,0,1,3,4,0
2000,MDA,61,Moldova,0,1,1,2,0
2000,KSA,61,Saudi Arabia,0,1,1,2,0
2000,TTO,61,Trinidad and Tobago,0,1,1,2,0
2000,IRL,64,Ireland,0,1,0,1,0
2000,SRI,64,Sri Lanka,0,1,0,1,0
2000,URU,64,Uruguay,0,1,0,1,0
2000,VIE,64,Vietnam,0,1,0,1,0
2000,GEO,68,Georgia,0,0,6,6,0
2000,CRC,69,Costa Rica,0,0,2,2,0
2000,POR,69,Portugal,0,0,2,2,0
2000,ARM,71,Armenia,0,0,1,1,0
2000,BAR,71,Barbados,0,0,1,1,0
2000,CHI,71,Chile,0,0,1,1,0
2000,ISL,71,Iceland,0,0,1,1,0
2000,IND,71,India,0,0,1,1,0
2000,ISR,71,Israel,0,0,1,1,0
2000,KUW,71,Kuwait,0,0,1,1,0
2000,KGZ,71,Kyrgyzstan,0,0,1,1,0
2000,MKD,71,Macedonia,0,0,1,1,0
2000,QAT,71,Qatar,0,0,1,1,0
2004,USA,1,United States,36,39,26,101,0
2004,CHN,2,China,32,17,14,63,0
2004,RUS,3,Russia,28,26,36,90,0
2004,RUS,3,Russia,28,26,36,90,0
2004,AUS,4,Australia,17,16,17,50,0
2004,JPN,5,Japan,16,9,12,37,0
2004,GER,6,Germany,13,16,20,49,0
2004,GER,6,Germany,13,16,20,49,0
2004,GER,6,Germany,13,16,20,49,0
2004,FRA,7,France,11,9,13,33,0
2004,ITA,8,Italy,10,11,11,32,0
2004,KOR,9,South Korea,9,12,9,30,0
2004,GBR,10,Great Britain,9,9,12,30,0
2004,CUB,11,Cuba,9,7,11,27,0
2004,HUN,12,Hungary,8,6,3,17,0
2004,UKR,13,Ukraine,8,5,9,22,0
2004,ROU,14,Romania,8,5,6,19,0
2004,GRE,15,Greece,6,6,4,16,1
2004,BRA,16,Brazil,5,2,3,10,0
2004,NOR,17,Norway,5,0,1,6,0
2004,NED,18,Netherlands,4,9,9,22,0
2004,SWE,19,Sweden,4,2,1,7,0
2004,ESP,20,Spain,3,11,6,20,0
2004,CAN,21,Canada,3,6,3,12,0
2004,TUR,22,Turkey,3,3,4,10,0
2004,POL,23,Poland,3,2,5,10,0
2004,NZL,24,New Zealand,3,2,0,5,0
2004,THA,25,Thailand,3,1,4,8,0
2004,BLR,26,Belarus,2,5,6,13,0
2004,AUT,27,Austria,2,4,1,7,0
2004,ETH,28,Ethiopia,2,3,2,7,0
2004,IRI,29,Iran,2,2,2,6,0
2004,SVK,29,Slovakia,2,2,2,6,0
2004,NA,31,Chinese Taipei,2,2,1,5,0
2004,GEO,32,Georgia,2,2,0,4,0
2004,BUL,33,Bulgaria,2,1,9,12,0
2004,DEN,34,Denmark,2,1,5,8,0
2004,JAM,35,Jamaica,2,1,2,5,0
2004,UZB,35,Uzbekistan,2,1,2,5,0
2004,MAR,37,Morocco,2,1,0,3,0
2004,ARG,38,Argentina,2,0,4,6,0
2004,CHI,39,Chile,2,0,1,3,0
2004,KAZ,40,Kazakhstan,1,4,3,8,0
2004,KEN,41,Kenya,1,4,2,7,0
2004,CZE,42,Czech Republic,1,3,5,9,0
2004,CZE,42,Czech Republic,1,3,5,9,0
2004,RSA,43,South Africa,1,3,2,6,0
2004,CRO,44,Croatia,1,2,2,5,0
2004,LTU,45,Lithuania,1,2,0,3,0
2004,EGY,46,Egypt,1,1,3,5,0
2004,SUI,46,Switzerland,1,1,3,5,0
2004,INA,48,Indonesia,1,1,2,4,0
2004,ZIM,49,Zimbabwe,1,1,1,3,0
2004,AZE,50,Azerbaijan,1,0,4,5,0
2004,BEL,51,Belgium,1,0,2,3,0
2004,BAH,52,Bahamas,1,0,1,2,0
2004,ISR,52,Israel,1,0,1,2,0
2004,CMR,54,Cameroon,1,0,0,1,0
2004,DOM,54,Dominican Republic,1,0,0,1,0
2004,UAE,54,United Arab Emirates,1,0,0,1,0
2004,PRK,57,North Korea,0,4,1,5,0
2004,LAT,58,Latvia,0,4,0,4,0
2004,MEX,59,Mexico,0,3,1,4,0
2004,POR,60,Portugal,0,2,1,3,0
2004,FIN,61,Finland,0,2,0,2,0
2004,NA,61,Serbia and Montenegro,0,2,0,2,0
2004,SLO,63,Slovenia,0,1,3,4,0
2004,EST,64,Estonia,0,1,2,3,0
2004,NA,65,Hong Kong,0,1,0,1,0
2004,IND,65,India,0,1,0,1,0
2004,PAR,65,Paraguay,0,1,0,1,0
2004,COL,68,Colombia,0,0,2,2,0
2004,NGR,68,Nigeria,0,0,2,2,0
2004,VEN,68,Venezuela,0,0,2,2,0
2004,ERI,71,Eritrea,0,0,1,1,0
2004,MGL,71,Mongolia,0,0,1,1,0
2004,SYR,71,Syria,0,0,1,1,0
2004,UAR,71,Syria,0,0,1,1,0
2004,TTO,71,Trinidad and Tobago,0,0,1,1,0
2008,CHN,1,China,48,22,30,100,1
2008,USA,2,United States,36,39,37,112,0
2008,RUS,3,Russia,24,13,23,60,0
2008,RUS,3,Russia,24,13,23,60,0
2008,GBR,4,Great Britain,19,13,19,51,0
2008,GER,5,Germany,16,11,14,41,0
2008,GER,5,Germany,16,11,14,41,0
2008,GER,5,Germany,16,11,14,41,0
2008,AUS,6,Australia,14,15,17,46,0
2008,KOR,7,South Korea,13,11,8,32,0
2008,JPN,8,Japan,9,8,8,25,0
2008,ITA,9,Italy,8,9,10,27,0
2008,FRA,10,France,7,16,20,43,0
2008,NED,11,Netherlands,7,5,4,16,0
2008,UKR,12,Ukraine,7,4,11,22,0
2008,KEN,13,Kenya,6,4,6,16,0
2008,ESP,14,Spain,5,11,3,19,0
2008,JAM,15,Jamaica,5,4,2,11,0
2008,POL,16,Poland,4,5,2,11,0
2008,ETH,17,Ethiopia,4,2,1,7,0
2008,ROU,18,Romania,4,1,4,9,0
2008,CUB,19,Cuba,3,10,17,30,0
2008,CAN,20,Canada,3,9,8,20,0
2008,HUN,21,Hungary,3,5,2,10,0
2008,NOR,22,Norway,3,5,1,9,0
2008,BRA,23,Brazil,3,4,10,17,0
2008,BLR,24,Belarus,3,4,7,14,0
2008,CZE,25,Czech Republic,3,3,1,7,0
2008,CZE,25,Czech Republic,3,3,1,7,0
2008,SVK,26,Slovakia,3,3,0,6,0
2008,NZL,27,New Zealand,3,2,4,9,0
2008,GEO,28,Georgia,3,2,2,7,0
2008,KAZ,29,Kazakhstan,2,3,4,9,0
2008,DEN,30,Denmark,2,2,3,7,0
2008,PRK,31,North Korea,2,2,2,6,0
2008,THA,31,Thailand,2,2,2,6,0
2008,MGL,33,Mongolia,2,2,0,4,0
2008,SUI,34,Switzerland,2,1,4,7,0
2008,ARG,35,Argentina,2,0,4,6,0
2008,MEX,36,Mexico,2,0,2,4,0
2008,BEL,37,Belgium,2,0,0,2,0
2008,ZIM,38,Zimbabwe,1,3,0,4,0
2008,SLO,39,Slovenia,1,2,2,5,0
2008,AZE,40,Azerbaijan,1,1,4,6,0
2008,INA,40,Indonesia,1,1,4,6,0
2008,BUL,42,Bulgaria,1,1,3,5,0
2008,TUR,42,Turkey,1,1,3,5,0
2008,NA,44,Chinese Taipei,1,1,2,4,0
2008,FIN,44,Finland,1,1,2,4,0
2008,LAT,46,Latvia,1,1,1,3,0
2008,DOM,47,Dominican Republic,1,1,0,2,0
2008,EST,47,Estonia,1,1,0,2,0
2008,POR,47,Portugal,1,1,0,2,0
2008,TTO,47,Trinidad and Tobago,1,1,0,2,0
2008,IND,51,India,1,0,2,3,0
2008,IRI,52,Iran,1,0,1,2,0
2008,CMR,53,Cameroon,1,0,0,1,0
2008,PAN,53,Panama,1,0,0,1,0
2008,TUN,53,Tunisia,1,0,0,1,0
2008,SWE,56,Sweden,0,4,1,5,0
2008,LTU,57,Lithuania,0,3,2,5,0
2008,NGR,57,Nigeria,0,3,2,5,0
2008,CRO,59,Croatia,0,2,3,5,0
2008,COL,60,Colombia,0,2,1,3,0
2008,GRE,60,Greece,0,2,1,3,0
2008,ARM,62,Armenia,0,1,4,5,0
2008,UZB,63,Uzbekistan,0,1,3,4,0
2008,AUT,64,Austria,0,1,2,3,0
2008,IRL,64,Ireland,0,1,2,3,0
2008,KGZ,64,Kyrgyzstan,0,1,2,3,0
2008,SRB,64,Serbia,0,1,2,3,0
2008,ALG,68,Algeria,0,1,1,2,0
2008,BAH,68,Bahamas,0,1,1,2,0
2008,MAR,68,Morocco,0,1,1,2,0
2008,TJK,68,Tajikistan,0,1,1,2,0
2008,CHI,72,Chile,0,1,0,1,0
2008,ECU,72,Ecuador,0,1,0,1,0
2008,ISL,72,Iceland,0,1,0,1,0
2008,MAS,72,Malaysia,0,1,0,1,0
2008,SAM,72,Samoa,0,1,0,1,0
2008,SIN,72,Singapore,0,1,0,1,0
2008,RSA,72,South Africa,0,1,0,1,0
2008,SUD,72,Sudan,0,1,0,1,0
2008,VIE,72,Vietnam,0,1,0,1,0
2008,EGY,81,Egypt,0,0,2,2,0
2008,AFG,82,Afghanistan,0,0,1,1,0
2008,ISR,82,Israel,0,0,1,1,0
2008,MRI,82,Mauritius,0,0,1,1,0
2008,MDA,82,Moldova,0,0,1,1,0
2008,TOG,82,Togo,0,0,1,1,0
2008,VEN,82,Venezuela,0,0,1,1,0
2012,USA,1,United States,48,26,31,105,0
2012,CHN,2,China,39,31,22,92,0
2012,GBR,3,Great Britain,29,18,18,65,0
2012,RUS,4,Russia,18,20,26,64,0
2012,RUS,4,Russia,18,20,26,64,0
2012,KOR,5,South Korea,13,9,9,31,0
2012,GER,6,Germany,11,20,13,44,0
2012,GER,6,Germany,11,20,13,44,0
2012,GER,6,Germany,11,20,13,44,0
2012,FRA,7,France,11,11,13,35,0
2012,AUS,8,Australia,8,15,12,35,0
2012,ITA,9,Italy,8,9,11,28,0
2012,HUN,10,Hungary,8,4,6,18,0
2012,JPN,11,Japan,7,14,17,38,0
2012,IRI,12,Iran,7,5,1,13,0
2012,NED,13,Netherlands,6,6,8,20,0
2012,NZL,14,New Zealand,6,2,5,13,0
2012,UKR,15,Ukraine,5,4,10,19,0
2012,CUB,16,Cuba,5,3,7,15,0
2012,ESP,17,Spain,4,10,6,20,0
2012,JAM,18,Jamaica,4,5,4,13,0
2012,CZE,19,Czech Republic,4,4,3,11,0
2012,CZE,19,Czech Republic,4,4,3,11,0
2012,RSA,20,South Africa,4,1,1,6,0
2012,PRK,21,North Korea,4,0,2,6,0
2012,BRA,22,Brazil,3,5,9,17,0
2012,KAZ,23,Kazakhstan,3,2,6,11,0
2012,POL,23,Poland,3,2,6,11,0
2012,ETH,25,Ethiopia,3,2,3,8,0
2012,CRO,26,Croatia,3,1,2,6,0
2012,CAN,27,Canada,2,6,10,18,0
2012,BLR,28,Belarus,2,5,3,10,0
2012,KEN,29,Kenya,2,4,7,13,0
2012,DEN,30,Denmark,2,4,3,9,0
2012,ROU,31,Romania,2,4,1,7,0
2012,AZE,32,Azerbaijan,2,2,5,9,0
2012,SUI,33,Switzerland,2,2,0,4,0
2012,NOR,34,Norway,2,1,1,4,0
2012,LTU,35,Lithuania,2,0,3,5,0
2012,TUN,36,Tunisia,2,0,1,3,0
2012,SWE,37,Sweden,1,4,3,8,0
2012,COL,38,Colombia,1,3,5,9,0
2012,MEX,39,Mexico,1,3,4,8,0
2012,GEO,40,Georgia,1,2,3,6,0
2012,IRL,41,Ireland,1,1,4,6,0
2012,ARG,42,Argentina,1,1,2,4,0
2012,SRB,42,Serbia,1,1,2,4,0
2012,SLO,42,Slovenia,1,1,2,4,0
2012,TTO,42,Trinidad and Tobago,1,1,2,4,0
2012,TUR,46,Turkey,1,1,1,3,0
2012,DOM,47,Dominican Republic,1,1,0,2,0
2012,NA,48,Chinese Taipei,1,0,1,2,0
2012,LAT,48,Latvia,1,0,1,2,0
2012,ALG,50,Algeria,1,0,0,1,0
2012,BAH,50,Bahamas,1,0,0,1,0
2012,BRN,50,Bahrain,1,0,0,1,0
2012,GRN,50,Grenada,1,0,0,1,0
2012,UGA,50,Uganda,1,0,0,1,0
2012,VEN,50,Venezuela,1,0,0,1,0
2012,EGY,56,Egypt,0,3,1,4,0
2012,IND,57,India,0,2,4,6,0
2012,MGL,58,Mongolia,0,2,3,5,0
2012,THA,59,Thailand,0,2,2,4,0
2012,BUL,60,Bulgaria,0,2,1,3,0
2012,FIN,60,Finland,0,2,1,3,0
2012,INA,60,Indonesia,0,2,1,3,0
2012,SVK,63,Slovakia,0,1,3,4,0
2012,BEL,64,Belgium,0,1,2,3,0
2012,ARM,65,Armenia,0,1,1,2,0
2012,EST,65,Estonia,0,1,1,2,0
2012,MAS,65,Malaysia,0,1,1,2,0
2012,PUR,65,Puerto Rico,0,1,1,2,0
2012,QAT,65,Qatar,0,1,1,2,0
2012,BOT,70,Botswana,0,1,0,1,0
2012,CYP,70,Cyprus,0,1,0,1,0
2012,GAB,70,Gabon,0,1,0,1,0
2012,GUA,70,Guatemala,0,1,0,1,0
2012,MNE,70,Montenegro,0,1,0,1,0
2012,POR,70,Portugal,0,1,0,1,0
2012,UZB,76,Uzbekistan,0,0,3,3,0
2012,GRE,77,Greece,0,0,2,2,0
2012,SIN,77,Singapore,0,0,2,2,0
2012,AFG,79,Afghanistan,0,0,1,1,0
2012,CMR,79,Cameroon,0,0,1,1,0
2012,NA,79,Hong Kong,0,0,1,1,0
2012,KUW,79,Kuwait,0,0,1,1,0
2012,MAR,79,Morocco,0,0,1,1,0
2012,KSA,79,Saudi Arabia,0,0,1,1,0
2012,TJK,79,Tajikistan,0,0,1,1,0
2012,VIE,79,Vietnam,0,0,1,1,0
2016,USA,1,United States,46,37,38,121,0
2016,GBR,2,Great Britain,27,23,17,67,0
2016,CHN,3,China,26,18,26,70,0
2016,RUS,4,Russia,19,17,20,56,0
2016,RUS,4,Russia,19,17,20,56,0
2016,GER,5,Germany,17,10,15,42,0
2016,GER,5,Germany,17,10,15,42,0
2016,GER,5,Germany,17,10,15,42,0
2016,JPN,6,Japan,12,8,21,41,0
2016,FRA,7,France,10,18,14,42,0
2016,KOR,8,South Korea,9,3,9,21,0
2016,ITA,9,Italy,8,12,8,28,0
2016,AUS,10,Australia,8,11,10,29,0
2016,NED,11,Netherlands,8,7,4,19,0
2016,HUN,12,Hungary,8,3,4,15,0
2016,BRA,13,Brazil,7,6,6,19,1
2016,ESP,14,Spain,7,4,6,17,0
2016,KEN,15,Kenya,6,6,1,13,0
2016,JAM,16,Jamaica,6,3,2,11,0
2016,CRO,17,Croatia,5,3,2,10,0
2016,CUB,18,Cuba,5,2,4,11,0
2016,NZL,19,New Zealand,4,9,5,18,0
2016,CAN,20,Canada,4,3,15,22,0
2016,UZB,21,Uzbekistan,4,2,7,13,0
2016,COL,22,Colombia,3,2,3,8,0
2016,SUI,23,Switzerland,3,2,2,7,0
2016,IRI,24,Iran,3,1,4,8,0
2016,GRE,25,Greece,3,1,2,6,0
2016,ARG,26,Argentina,3,1,0,4,0
2016,DEN,27,Denmark,2,6,7,15,0
2016,SWE,28,Sweden,2,6,3,11,0
2016,RSA,29,South Africa,2,6,2,10,0
2016,KAZ,30,Kazakhstan,2,5,10,17,0
2016,UKR,31,Ukraine,2,5,4,11,0
2016,SRB,32,Serbia,2,4,2,8,0
2016,POL,33,Poland,2,3,6,11,0
2016,PRK,34,North Korea,2,3,2,7,0
2016,BEL,35,Belgium,2,2,2,6,0
2016,THA,35,Thailand,2,2,2,6,0
2016,SVK,37,Slovakia,2,2,0,4,0
2016,GEO,38,Georgia,2,1,4,7,0
2016,AZE,39,Azerbaijan,1,7,10,18,0
2016,BLR,40,Belarus,1,4,4,9,0
2016,TUR,41,Turkey,1,3,4,8,0
2016,ARM,42,Armenia,1,3,0,4,0
2016,CZE,43,Czech Republic,1,2,7,10,0
2016,CZE,43,Czech Republic,1,2,7,10,0
2016,ETH,44,Ethiopia,1,2,5,8,0
2016,SLO,45,Slovenia,1,2,1,4,0
2016,INA,46,Indonesia,1,2,0,3,0
2016,ROU,47,Romania,1,1,2,4,0
2016,BRN,48,Bahrain,1,1,0,2,0
2016,VIE,48,Vietnam,1,1,0,2,0
2016,NA,50,Chinese Taipei,1,0,2,3,0
2016,BAH,51,Bahamas,1,0,1,2,0
2016,NA,51,Independent Olympic Athletes,1,0,1,2,0
2016,CIV,51,Ivory Coast,1,0,1,2,0
2016,FIJ,54,Fiji,1,0,0,1,0
2016,JOR,54,Jordan,1,0,0,1,0
2016,KOS,54,Kosovo,1,0,0,1,0
2016,PUR,54,Puerto Rico,1,0,0,1,0
2016,SIN,54,Singapore,1,0,0,1,0
2016,TJK,54,Tajikistan,1,0,0,1,0
2016,MAS,60,Malaysia,0,4,1,5,0
2016,MEX,61,Mexico,0,3,2,5,0
2016,VEN,62,Venezuela,0,2,1,3,0
2016,ALG,63,Algeria,0,2,0,2,0
2016,IRL,63,Ireland,0,2,0,2,0
2016,LTU,65,Lithuania,0,1,3,4,0
2016,BUL,66,Bulgaria,0,1,2,3,0
2016,IND,67,India,0,1,1,2,0
2016,MGL,67,Mongolia,0,1,1,2,0
2016,BDI,69,Burundi,0,1,0,1,0
2016,GRN,69,Grenada,0,1,0,1,0
2016,NIG,69,Niger,0,1,0,1,0
2016,PHI,69,Philippines,0,1,0,1,0
2016,QAT,69,Qatar,0,1,0,1,0
2016,NOR,74,Norway,0,0,4,4,0
2016,EGY,75,Egypt,0,0,3,3,0
2016,TUN,75,Tunisia,0,0,3,3,0
2016,ISR,77,Israel,0,0,2,2,0
2016,AUT,78,Austria,0,0,1,1,0
2016,DOM,78,Dominican Republic,0,0,1,1,0
2016,EST,78,Estonia,0,0,1,1,0
2016,FIN,78,Finland,0,0,1,1,0
2016,MAR,78,Morocco,0,0,1,1,0
2016,NGR,78,Nigeria,0,0,1,1,0
2016,POR,78,Portugal,0,0,1,1,0
2016,TTO,78,Trinidad and Tobago,0,0,1,1,0
2016,UAE,78,United Arab Emirates,0,0,1,1,0
2020,USA,1,United States,39,41,33,113,0
2020,CHN,2,China,38,32,19,89,0
2020,JPN,3,Japan,27,14,17,58,1
2020,GBR,4,Great Britain,22,20,22,64,0
2020,NA,5,ROC,20,28,23,71,0
2020,AUS,6,Australia,17,7,22,46,0
2020,NED,7,Netherlands,10,12,14,36,0
2020,FRA,8,France,10,12,11,33,0
2020,GER,9,Germany,10,11,16,37,0
2020,GER,9,Germany,10,11,16,37,0
2020,GER,9,Germany,10,11,16,37,0
2020,ITA,10,Italy,10,10,20,40,0
2020,CAN,11,Canada,7,7,10,24,0
2020,BRA,12,Brazil,7,6,8,21,0
2020,NZL,13,New Zealand,7,6,7,20,0
2020,CUB,14,Cuba,7,3,5,15,0
2020,HUN,15,Hungary,6,7,7,20,0
2020,KOR,16,South Korea,6,4,10,20,0
2020,POL,17,Poland,4,5,5,14,0
2020,CZE,18,Czech Republic,4,4,3,11,0
2020,CZE,18,Czech Republic,4,4,3,11,0
2020,KEN,19,Kenya,4,4,2,10,0
2020,NOR,20,Norway,4,2,2,8,0
2020,JAM,21,Jamaica,4,1,4,9,0
2020,ESP,22,Spain,3,8,6,17,0
2020,SWE,23,Sweden,3,6,0,9,0
2020,SUI,24,Switzerland,3,4,6,13,0
2020,DEN,25,Denmark,3,4,4,11,0
2020,CRO,26,Croatia,3,3,2,8,0
2020,IRI,27,Iran,3,2,2,7,0
2020,SRB,28,Serbia,3,1,5,9,0
2020,BEL,29,Belgium,3,1,3,7,0
2020,BUL,30,Bulgaria,3,1,2,6,0
2020,SLO,31,Slovenia,3,1,1,5,0
2020,UZB,32,Uzbekistan,3,0,2,5,0
2020,GEO,33,Georgia,2,5,1,8,0
2020,NA,34,Chinese Taipei,2,4,6,12,0
2020,TUR,35,Turkey,2,2,9,13,0
2020,GRE,36,Greece,2,1,1,4,0
2020,UGA,36,Uganda,2,1,1,4,0
2020,ECU,38,Ecuador,2,1,0,3,0
2020,IRL,39,Ireland,2,0,2,4,0
2020,ISR,39,Israel,2,0,2,4,0
2020,QAT,41,Qatar,2,0,1,3,0
2020,BAH,42,Bahamas,2,0,0,2,0
2020,KOS,42,Kosovo,2,0,0,2,0
2020,UKR,44,Ukraine,1,6,12,19,0
2020,BLR,45,Belarus,1,3,3,7,0
2020,ROU,46,Romania,1,3,0,4,0
2020,VEN,46,Venezuela,1,3,0,4,0
2020,IND,48,India,1,2,4,7,0
2020,NA,49,Hong Kong,1,2,3,6,0
2020,PHI,50,Philippines,1,2,1,4,0
2020,SVK,50,Slovakia,1,2,1,4,0
2020,RSA,52,South Africa,1,2,0,3,0
2020,AUT,53,Austria,1,1,5,7,0
2020,EGY,54,Egypt,1,1,4,6,0
2020,INA,55,Indonesia,1,1,3,5,0
2020,ETH,56,Ethiopia,1,1,2,4,0
2020,POR,56,Portugal,1,1,2,4,0
2020,TUN,58,Tunisia,1,1,0,2,0
2020,EST,59,Estonia,1,0,1,2,0
2020,FIJ,59,Fiji,1,0,1,2,0
2020,LAT,59,Latvia,1,0,1,2,0
2020,THA,59,Thailand,1,0,1,2,0
2020,BER,63,Bermuda,1,0,0,1,0
2020,MAR,63,Morocco,1,0,0,1,0
2020,PUR,63,Puerto Rico,1,0,0,1,0
2020,COL,66,Colombia,0,4,1,5,0
2020,AZE,67,Azerbaijan,0,3,4,7,0
2020,DOM,68,Dominican Republic,0,3,2,5,0
2020,ARM,69,Armenia,0,2,2,4,0
2020,KGZ,70,Kyrgyzstan,0,2,1,3,0
2020,MGL,71,Mongolia,0,1,3,4,0
2020,ARG,72,Argentina,0,1,2,3,0
2020,SMR,72,San Marino,0,1,2,3,0
2020,JOR,74,Jordan,0,1,1,2,0
2020,MAS,74,Malaysia,0,1,1,2,0
2020,NGR,74,Nigeria,0,1,1,2,0
2020,BRN,77,Bahrain,0,1,0,1,0
2020,LTU,77,Lithuania,0,1,0,1,0
2020,NAM,77,Namibia,0,1,0,1,0
2020,NA,77,North Macedonia,0,1,0,1,0
2020,KSA,77,Saudi Arabia,0,1,0,1,0
2020,TKM,77,Turkmenistan,0,1,0,1,0
2020,KAZ,83,Kazakhstan,0,0,8,8,0
2020,MEX,84,Mexico,0,0,4,4,0
2020,FIN,85,Finland,0,0,2,2,0
2020,BOT,86,Botswana,0,0,1,1,0
2020,BUR,86,Burkina Faso,0,0,1,1,0
2020,GHA,86,Ghana,0,0,1,1,0
2020,GRN,86,Grenada,0,0,1,1,0
2020,CIV,86,Ivory Coast,0,0,1,1,0
2020,KUW,86,Kuwait,0,0,1,1,0
2020,MDA,86,Moldova,0,0,1,1,0
2020,SYR,86,Syria,0,0,1,1,0
2020,UAR,86,Syria,0,0,1,1,0
2024,USA,1,United States,40,44,42,126,0
2024,CHN,2,China,40,27,24,91,0
2024,JPN,3,Japan,20,12,13,45,0
2024,AUS,4,Australia,18,19,16,53,0
2024,FRA,5,France,16,26,22,64,1
2024,NED,6,Netherlands,15,7,12,34,0
2024,GBR,7,Great Britain,14,22,29,65,0
2024,KOR,8,South Korea,13,9,10,32,0
2024,ITA,9,Italy,12,13,15,40,0
2024,GER,10,Germany,12,13,8,33,0
2024,GER,10,Germany,12,13,8,33,0
2024,GER,10,Germany,12,13,8,33,0
2024,NZL,11,New Zealand,10,7,3,20,0
2024,CAN,12,Canada,9,7,11,27,0
2024,UZB,13,Uzbekistan,8,2,3,13,0
2024,HUN,14,Hungary,6,7,6,19,0
2024,ESP,15,Spain,5,4,9,18,0
2024,SWE,16,Sweden,4,4,3,11,0
2024,KEN,17,Kenya,4,2,5,11,0
2024,NOR,18,Norway,4,1,3,8,0
2024,IRL,19,Ireland,4,0,3,7,0
2024,BRA,20,Brazil,3,7,10,20,0
2024,IRI,21,Iran,3,6,3,12,0
2024,UKR,22,Ukraine,3,5,4,12,0
2024,ROU,23,Romania,3,4,2,9,0
2024,GEO,24,Georgia,3,3,1,7,0
2024,BEL,25,Belgium,3,1,6,10,0
2024,BUL,26,Bulgaria,3,1,3,7,0
2024,SRB,27,Serbia,3,1,1,5,0
2024,CZE,28,Czech Republic,3,0,2,5,0
2024,CZE,28,Czech Republic,3,0,2,5,0
2024,DEN,29,Denmark,2,2,5,9,0
2024,AZE,30,Azerbaijan,2,2,3,7,0
2024,CRO,30,Croatia,2,2,3,7,0
2024,CUB,32,Cuba,2,1,6,9,0
2024,BRN,33,Bahrain,2,1,1,4,0
2024,SLO,34,Slovenia,2,1,0,3,0
2024,NA,35,Chinese Taipei,2,0,5,7,0
2024,AUT,36,Austria,2,0,3,5,0
2024,NA,37,Hong Kong,2,0,2,4,0
2024,PHI,37,Philippines,2,0,2,4,0
2024,ALG,39,Algeria,2,0,1,3,0
2024,INA,39,Indonesia,2,0,1,3,0
2024,ISR,41,Israel,1,5,1,7,0
2024,POL,42,Poland,1,4,5,10,0
2024,KAZ,43,Kazakhstan,1,3,3,7,0
2024,JAM,44,Jamaica,1,3,2,6,0
2024,RSA,44,South Africa,1,3,2,6,0
2024,THA,44,Thailand,1,3,2,6,0
2024,NA,NA,Individual Neutral Athletes,1,3,1,5,0
2024,ETH,47,Ethiopia,1,3,0,4,0
2024,SUI,48,Switzerland,1,2,5,8,0
2024,ECU,49,Ecuador,1,2,2,5,0
2024,POR,50,Portugal,1,2,1,4,0
2024,GRE,51,Greece,1,1,6,8,0
2024,ARG,52,Argentina,1,1,1,3,0
2024,EGY,52,Egypt,1,1,1,3,0
2024,TUN,52,Tunisia,1,1,1,3,0
2024,BOT,55,Botswana,1,1,0,2,0
2024,CHI,55,Chile,1,1,0,2,0
2024,LCA,55,Saint Lucia,1,1,0,2,0
2024,UGA,55,Uganda,1,1,0,2,0
2024,DOM,59,Dominican Republic,1,0,2,3,0
2024,GUA,60,Guatemala,1,0,1,2,0
2024,MAR,60,Morocco,1,0,1,2,0
2024,DMA,62,Dominica,1,0,0,1,0
2024,PAK,62,Pakistan,1,0,0,1,0
2024,TUR,64,Turkey,0,3,5,8,0
2024,MEX,65,Mexico,0,3,2,5,0
2024,ARM,66,Armenia,0,3,1,4,0
2024,COL,66,Colombia,0,3,1,4,0
2024,KGZ,68,Kyrgyzstan,0,2,4,6,0
2024,PRK,68,North Korea,0,2,4,6,0
2024,LTU,70,Lithuania,0,2,2,4,0
2024,IND,71,India,0,1,5,6,0
2024,MDA,72,Moldova,0,1,3,4,0
2024,KOS,73,Kosovo,0,1,1,2,0
2024,CYP,74,Cyprus,0,1,0,1,0
2024,FIJ,74,Fiji,0,1,0,1,0
2024,JOR,74,Jordan,0,1,0,1,0
2024,MGL,74,Mongolia,0,1,0,1,0
2024,PAN,74,Panama,0,1,0,1,0
2024,TJK,79,Tajikistan,0,0,3,3,0
2024,ALB,80,Albania,0,0,2,2,0
2024,GRN,80,Grenada,0,0,2,2,0
2024,MAS,80,Malaysia,0,0,2,2,0
2024,PUR,80,Puerto Rico,0,0,2,2,0
2024,CPV,84,Cape Verde,0,0,1,1,0
2024,CIV,84,Ivory Coast,0,0,1,1,0
2024,PER,84,Peru,0,0,1,1,0
2024,QAT,84,Qatar,0,0,1,1,0
2024,NA,84,Refugee Olympic Team,0,0,1,1,0
2024,SIN,84,Singapore,0,0,1,1,0
2024,SVK,84,Slovakia,0,0,1,1,0
2024,ZAM,84,Zambia,0,0,1,1,0
1932,USA,1,United States,44,36,30,110,1
1932,ITA,2,Italy,12,12,12,36,0
1932,FRA,3,France,11,5,4,20,0
1932,SWE,4,Sweden,10,5,9,24,0
1932,JPN,5,Japan,7,7,4,18,0
1932,HUN,6,Hungary,6,5,5,16,0
1932,FIN,7,Finland,5,8,12,25,0
1932,GBR,8,Great Britain,5,7,5,17,0
1932,GER,9,Germany,3,12,7,22,0
1932,GER,9,Germany,3,12,7,22,0
1932,GER,9,Germany,3,12,7,22,0
1932,POL,10,Poland,3,2,4,9,0
1932,AUS,11,Australia,3,1,1,5,0
1932,ARG,12,Argentina,3,1,0,4,0
1932,CAN,13,Canada,2,5,9,16,0
1932,NED,14,Netherlands,2,5,1,8,0
1932,RSA,15,South Africa,2,0,3,5,0
1932,IRL,16,Ireland,2,0,0,2,0
1932,CZE,17,Czechoslovakia,1,3,2,6,0
1932,AUT,18,Austria,1,1,3,5,0
1932,IND,19,India,1,0,0,1,0
1932,DEN,20,Denmark,0,5,3,8,0
1932,MEX,21,Mexico,0,2,0,2,0
1932,LAT,22,Latvia,0,1,0,1,0
1932,NZL,22,New Zealand,0,1,0,1,0
1932,SUI,22,Switzerland,0,1,0,1,0
1932,PHI,25,Philippines,0,0,3,3,0
1932,BEL,26,Belgium,0,0,1,1,0
1932,ESP,26,Spain,0,0,1,1,0
1932,URU,26,Uruguay,0,0,1,1,0
1960,RUS,1,Soviet Union,43,29,31,103,0
1960,USA,2,United States,34,21,16,71,0
1960,ITA,3,Italy,13,10,13,36,0
1960,GER,4,United Team of Germany,12,19,11,42,0
1960,AUS,5,Australia,8,8,6,22,0
1960,TUR,6,Turkey,7,2,0,9,0
1960,HUN,7,Hungary,6,8,7,21,0
1960,JPN,8,Japan,4,7,7,18,0
1960,POL,9,Poland,4,6,11,21,0
1960,CZE,10,Czechoslovakia,3,2,3,8,0
1960,ROU,11,Romania,3,1,6,10,0
1960,GBR,12,Great Britain,2,6,12,20,0
1960,DEN,13,Denmark,2,3,1,6,0
1960,NZL,14,New Zealand,2,0,1,3,0
1960,BUL,15,Bulgaria,1,3,3,7,0
1960,SWE,16,Sweden,1,2,3,6,0
1960,FIN,17,Finland,1,1,3,5,0
1960,AUT,18,Austria,1,1,0,2,0
1960,SRB,18,Yugoslavia,1,1,0,2,0
1960,PAK,20,Pakistan,1,0,1,2,0
1960,ETH,21,Ethiopia,1,0,0,1,0
1960,GRE,21,Greece,1,0,0,1,0
1960,NOR,21,Norway,1,0,0,1,0
1960,SUI,24,Switzerland,0,3,3,6,0
1960,FRA,25,France,0,2,3,5,0
1960,BEL,26,Belgium,0,2,2,4,0
1960,IRI,27,Iran,0,1,3,4,0
1960,NED,28,Netherlands,0,1,2,3,0
1960,RSA,28,South Africa,0,1,2,3,0
1960,ARG,30,Argentina,0,1,1,2,0
1960,EGY,30,Egypt,0,1,1,2,0
1960,CAN,32,Canada,0,1,0,1,0
1960,NA,32,Formosa,0,1,0,1,0
1960,GHA,32,Ghana,0,1,0,1,0
1960,IND,32,India,0,1,0,1,0
1960,MAR,32,Morocco,0,1,0,1,0
1960,POR,32,Portugal,0,1,0,1,0
1960,SIN,32,Singapore,0,1,0,1,0
1960,BRA,39,Brazil,0,0,2,2,0
1960,NA,39,British West Indies,0,0,2,2,0
1960,IRQ,41,Iraq,0,0,1,1,0
1960,MEX,41,Mexico,0,0,1,1,0
1960,ESP,41,Spain,0,0,1,1,0
1960,VEN,41,Venezuela,0,0,1,1,0
