id,olympic_year,olympic_rank,region_participate,medal_gold,medal_silver,medal_bronze,medal_total,country_host,NOC
1896_USA,1896,1,United States,11,7,2,20,0,USA
1896_GRE,1896,2,Greece,10,18,19,47,1,GRE
1896_GER,1896,3,Germany,6,5,2,13,0,GER
1896_GER,1896,3,Germany,6,5,2,13,0,GER
1896_GER,1896,3,Germany,6,5,2,13,0,GER
1896_FRA,1896,4,France,5,4,2,11,0,FRA
1896_GBR,1896,5,Great Britain,2,3,2,7,0,GBR
1896_HUN,1896,6,Hungary,2,1,3,6,0,HUN
1896_AUT,1896,7,Austria,2,1,2,5,0,AUT
1896_AUS,1896,8,Australia,2,0,0,2,0,AUS
1896_DEN,1896,9,Denmark,1,2,3,6,0,DEN
1896_SUI,1896,10,Switzerland,1,2,0,3,0,SUI
1900_FRA,1900,1,France,31,41,40,112,1,FRA
1900_USA,1900,2,United States,20,13,15,48,0,USA
1900_GBR,1900,3,Great Britain,20,8,9,37,0,GBR
1900_BEL,1900,4,Belgium,6,6,6,18,0,BEL
1900_SUI,1900,5,Switzerland,6,3,1,10,0,SUI
1900_GER,1900,6,Germany,4,3,2,9,0,GER
1900_GER,1900,6,Germany,4,3,2,9,0,GER
1900_GER,1900,6,Germany,4,3,2,9,0,GER
1900_ITA,1900,7,Italy,3,2,0,5,0,ITA
1900_DEN,1900,8,Denmark,1,3,2,6,0,DEN
1900_NED,1900,9,Netherlands,1,2,3,6,0,NED
1900_HUN,1900,11,Hungary,1,2,2,5,0,HUN
1900_CUB,1900,12,Cuba,1,1,0,2,0,CUB
1900_ESP,1900,13,Spain,1,0,0,1,0,ESP
1900_AUT,1900,14,Austria,0,3,3,6,0,AUT
1900_NOR,1900,15,Norway,0,2,3,5,0,NOR
1900_IND,1900,16,India,0,2,0,2,0,IND
1900_CZE,1900,17,Bohemia,0,1,1,2,0,CZE
1900_AUS,1900,18,Australia,0,0,3,3,0,AUS
1900_SWE,1900,19,Sweden,0,0,1,1,0,SWE
1904_USA,1904,1,United States,77,79,78,234,1,USA
1904_GER,1904,2,Germany,4,5,6,15,0,GER
1904_GER,1904,2,Germany,4,5,6,15,0,GER
1904_GER,1904,2,Germany,4,5,6,15,0,GER
1904_CAN,1904,3,Canada,4,1,1,6,0,CAN
1904_CUB,1904,4,Cuba,3,0,0,3,0,CUB
1904_HUN,1904,5,Hungary,2,1,1,4,0,HUN
1904_NOR,1904,6,Norway,2,0,0,2,0,NOR
1904_AUT,1904,7,Austria,1,1,1,3,0,AUT
1904_GBR,1904,8,Great Britain,1,1,0,2,0,GBR
1904_SUI,1904,9,Switzerland,1,0,2,3,0,SUI
1904_GRE,1904,10,Greece,1,0,1,2,0,GRE
1904_AUS,1904,12,Australia,0,3,1,4,0,AUS
1904_FRA,1904,13,France,0,1,0,1,0,FRA
1908_GBR,1908,1,Great Britain,56,51,39,146,0,GBR
1908_USA,1908,2,United States,23,12,12,47,0,USA
1908_SWE,1908,3,Sweden,8,6,11,25,0,SWE
1908_FRA,1908,4,France,5,5,9,19,0,FRA
1908_GER,1908,5,Germany,3,5,5,13,0,GER
1908_GER,1908,5,Germany,3,5,5,13,0,GER
1908_GER,1908,5,Germany,3,5,5,13,0,GER
1908_HUN,1908,6,Hungary,3,4,2,9,0,HUN
1908_CAN,1908,7,Canada,3,3,10,16,0,CAN
1908_NOR,1908,8,Norway,2,3,3,8,0,NOR
1908_ITA,1908,9,Italy,2,2,0,4,0,ITA
1908_BEL,1908,10,Belgium,1,5,2,8,0,BEL
1908_AUS,1908,11,Australasia,1,2,2,5,0,AUS
1908_RUS,1908,12,Russian Empire,1,2,0,3,0,RUS
1908_FIN,1908,13,Finland,1,1,3,5,0,FIN
1908_RSA,1908,14,South Africa,1,1,0,2,0,RSA
1908_GRE,1908,15,Greece,0,3,1,4,0,GRE
1908_DEN,1908,16,Denmark,0,2,3,5,0,DEN
1908_CZE,1908,17,Bohemia,0,0,2,2,0,CZE
1908_NED,1908,17,Netherlands,0,0,2,2,0,NED
1908_AUT,1908,19,Austria,0,0,1,1,0,AUT
1912_USA,1912,1,United States,26,19,19,64,0,USA
1912_SWE,1912,2,Sweden,23,25,17,65,1,SWE
1912_GBR,1912,3,Great Britain,10,15,16,41,0,GBR
1912_FIN,1912,4,Finland,9,8,9,26,0,FIN
1912_FRA,1912,5,France,7,4,3,14,0,FRA
1912_GER,1912,6,Germany,5,13,7,25,0,GER
1912_GER,1912,6,Germany,5,13,7,25,0,GER
1912_GER,1912,6,Germany,5,13,7,25,0,GER
1912_RSA,1912,7,South Africa,4,2,0,6,0,RSA
1912_NOR,1912,8,Norway,3,2,5,10,0,NOR
1912_CAN,1912,9,Canada,3,2,3,8,0,CAN
1912_HUN,1912,9,Hungary,3,2,3,8,0,HUN
1912_ITA,1912,11,Italy,3,1,2,6,0,ITA
1912_AUS,1912,12,Australasia,2,2,3,7,0,AUS
1912_BEL,1912,13,Belgium,2,1,3,6,0,BEL
1912_DEN,1912,14,Denmark,1,6,5,12,0,DEN
1912_GRE,1912,15,Greece,1,0,1,2,0,GRE
1912_RUS,1912,16,Russian Empire,0,2,3,5,0,RUS
1912_AUT,1912,17,Austria,0,2,2,4,0,AUT
1912_NED,1912,18,Netherlands,0,0,3,3,0,NED
1920_USA,1920,1,United States,41,27,27,95,0,USA
1920_SWE,1920,2,Sweden,19,20,25,64,0,SWE
1920_FIN,1920,3,Finland,15,10,9,34,0,FIN
1920_GBR,1920,4,Great Britain,14,15,13,42,0,GBR
1920_BEL,1920,5,Belgium,14,11,11,36,1,BEL
1920_NOR,1920,6,Norway,13,9,9,31,0,NOR
1920_ITA,1920,7,Italy,13,5,5,23,0,ITA
1920_FRA,1920,8,France,9,19,13,41,0,FRA
1920_NED,1920,9,Netherlands,4,2,5,11,0,NED
1920_DEN,1920,10,Denmark,3,9,1,13,0,DEN
1920_RSA,1920,11,South Africa,3,4,3,10,0,RSA
1920_CAN,1920,12,Canada,3,3,3,9,0,CAN
1920_SUI,1920,13,Switzerland,2,2,7,11,0,SUI
1920_EST,1920,14,Estonia,1,2,0,3,0,EST
1920_BRA,1920,15,Brazil,1,1,1,3,0,BRA
1920_AUS,1920,16,Australia,0,2,1,3,0,AUS
1920_JPN,1920,17,Japan,0,2,0,2,0,JPN
1920_ESP,1920,17,Spain,0,2,0,2,0,ESP
1920_GRE,1920,19,Greece,0,1,0,1,0,GRE
1920_LUX,1920,19,Luxembourg,0,1,0,1,0,LUX
1920_CZE,1920,21,Czechoslovakia,0,0,2,2,0,CZE
1920_NZL,1920,22,New Zealand,0,0,1,1,0,NZL
1924_USA,1924,1,United States,45,27,27,99,0,USA
1924_FIN,1924,2,Finland,14,13,10,37,0,FIN
1924_FRA,1924,3,France,13,15,10,38,1,FRA
1924_GBR,1924,4,Great Britain,9,13,12,34,0,GBR
1924_ITA,1924,5,Italy,8,3,5,16,0,ITA
1924_SUI,1924,6,Switzerland,7,8,10,25,0,SUI
1924_NOR,1924,7,Norway,5,2,3,10,0,NOR
1924_SWE,1924,8,Sweden,4,13,12,29,0,SWE
1924_NED,1924,9,Netherlands,4,1,5,10,0,NED
1924_BEL,1924,10,Belgium,3,7,3,13,0,BEL
1924_AUS,1924,11,Australia,3,1,2,6,0,AUS
1924_DEN,1924,12,Denmark,2,5,2,9,0,DEN
1924_HUN,1924,13,Hungary,2,3,4,9,0,HUN
1924_SRB,1924,14,Yugoslavia,2,0,0,2,0,SRB
1924_CZE,1924,15,Czechoslovakia,1,4,5,10,0,CZE
1924_ARG,1924,16,Argentina,1,3,2,6,0,ARG
1924_EST,1924,17,Estonia,1,1,4,6,0,EST
1924_RSA,1924,18,South Africa,1,1,1,3,0,RSA
1924_URU,1924,19,Uruguay,1,0,0,1,0,URU
1924_AUT,1924,20,Austria,0,3,1,4,0,AUT
1924_CAN,1924,20,Canada,0,3,1,4,0,CAN
1924_POL,1924,22,Poland,0,1,1,2,0,POL
1924_HAI,1924,23,Haiti,0,0,1,1,0,HAI
1924_JPN,1924,23,Japan,0,0,1,1,0,JPN
1924_NZL,1924,23,New Zealand,0,0,1,1,0,NZL
1924_POR,1924,23,Portugal,0,0,1,1,0,POR
1924_ROU,1924,23,Romania,0,0,1,1,0,ROU
1928_USA,1928,1,United States,22,18,16,56,0,USA
1928_GER,1928,2,Germany,10,7,14,31,0,GER
1928_GER,1928,2,Germany,10,7,14,31,0,GER
1928_GER,1928,2,Germany,10,7,14,31,0,GER
1928_FIN,1928,3,Finland,8,8,9,25,0,FIN
1928_SWE,1928,4,Sweden,7,6,12,25,0,SWE
1928_ITA,1928,5,Italy,7,5,7,19,0,ITA
1928_SUI,1928,6,Switzerland,7,4,4,15,0,SUI
1928_FRA,1928,7,France,6,10,5,21,0,FRA
1928_NED,1928,8,Netherlands,6,9,4,19,1,NED
1928_HUN,1928,9,Hungary,4,5,0,9,0,HUN
1928_CAN,1928,10,Canada,4,4,7,15,0,CAN
1928_GBR,1928,11,Great Britain,3,10,7,20,0,GBR
1928_ARG,1928,12,Argentina,3,3,1,7,0,ARG
1928_DEN,1928,13,Denmark,3,1,2,6,0,DEN
1928_CZE,1928,14,Czechoslovakia,2,5,2,9,0,CZE
1928_JPN,1928,15,Japan,2,2,1,5,0,JPN
1928_EST,1928,16,Estonia,2,1,2,5,0,EST
1928_EGY,1928,17,Egypt,2,1,1,4,0,EGY
1928_AUT,1928,18,Austria,2,0,1,3,0,AUT
1928_AUS,1928,19,Australia,1,2,1,4,0,AUS
1928_NOR,1928,19,Norway,1,2,1,4,0,NOR
1928_POL,1928,21,Poland,1,1,3,5,0,POL
1928_SRB,1928,21,Yugoslavia,1,1,3,5,0,SRB
1928_RSA,1928,23,South Africa,1,0,2,3,0,RSA
1928_IND,1928,24,India,1,0,0,1,0,IND
1928_IRL,1928,24,Ireland,1,0,0,1,0,IRL
1928_NZL,1928,24,New Zealand,1,0,0,1,0,NZL
1928_ESP,1928,24,Spain,1,0,0,1,0,ESP
1928_URU,1928,24,Uruguay,1,0,0,1,0,URU
1928_BEL,1928,29,Belgium,0,1,2,3,0,BEL
1928_CHI,1928,30,Chile,0,1,0,1,0,CHI
1928_HAI,1928,30,Haiti,0,1,0,1,0,HAI
1928_PHI,1928,32,Philippines,0,0,1,1,0,PHI
1928_POR,1928,32,Portugal,0,0,1,1,0,POR
1936_GER,1936,1,Germany,38,31,32,101,1,GER
1936_GER,1936,1,Germany,38,31,32,101,1,GER
1936_GER,1936,1,Germany,38,31,32,101,1,GER
1936_USA,1936,2,United States,24,21,12,57,0,USA
1936_HUN,1936,3,Hungary,10,1,5,16,0,HUN
1936_ITA,1936,4,Italy,9,13,5,27,0,ITA
1936_FIN,1936,5,Finland,8,6,6,20,0,FIN
1936_FRA,1936,6,France,7,6,6,19,0,FRA
1936_SWE,1936,7,Sweden,6,5,10,21,0,SWE
1936_JPN,1936,8,Japan,6,4,10,20,0,JPN
1936_NED,1936,9,Netherlands,6,4,7,17,0,NED
1936_AUT,1936,10,Austria,5,7,5,17,0,AUT
1936_SUI,1936,11,Switzerland,4,9,5,18,0,SUI
1936_GBR,1936,12,Great Britain,4,7,3,14,0,GBR
1936_CZE,1936,13,Czechoslovakia,3,5,1,9,0,CZE
1936_ARG,1936,14,Argentina,2,2,3,7,0,ARG
1936_EST,1936,14,Estonia,2,2,3,7,0,EST
1936_EGY,1936,16,Egypt,2,1,2,5,0,EGY
1936_CAN,1936,17,Canada,1,3,5,9,0,CAN
1936_NOR,1936,18,Norway,1,3,2,6,0,NOR
1936_TUR,1936,19,Turkey,1,0,1,2,0,TUR
1936_IND,1936,20,India,1,0,0,1,0,IND
1936_NZL,1936,20,New Zealand,1,0,0,1,0,NZL
1936_POL,1936,22,Poland,0,4,5,9,0,POL
1936_DEN,1936,23,Denmark,0,2,3,5,0,DEN
1936_LAT,1936,24,Latvia,0,1,1,2,0,LAT
1936_ROU,1936,25,Romania,0,1,0,1,0,ROU
1936_RSA,1936,25,South Africa,0,1,0,1,0,RSA
1936_SRB,1936,25,Yugoslavia,0,1,0,1,0,SRB
1936_BEL,1936,28,Belgium,0,0,3,3,0,BEL
1936_MEX,1936,28,Mexico,0,0,3,3,0,MEX
1936_AUS,1936,30,Australia,0,0,1,1,0,AUS
1936_PHI,1936,30,Philippines,0,0,1,1,0,PHI
1936_POR,1936,30,Portugal,0,0,1,1,0,POR
1948_USA,1948,1,United States,38,27,19,84,0,USA
1948_SWE,1948,2,Sweden,17,11,18,46,0,SWE
1948_FRA,1948,3,France,11,6,15,32,0,FRA
1948_FIN,1948,4,Finland,10,8,6,24,0,FIN
1948_HUN,1948,5,Hungary,10,5,13,28,0,HUN
1948_ITA,1948,6,Italy,9,12,10,31,0,ITA
1948_TUR,1948,7,Turkey,6,4,2,12,0,TUR
1948_CZE,1948,8,Czechoslovakia,6,2,3,11,0,CZE
1948_SUI,1948,9,Switzerland,5,12,6,23,1,SUI
1948_DEN,1948,10,Denmark,5,8,9,22,0,DEN
1948_NED,1948,11,Netherlands,5,2,9,16,0,NED
1948_GBR,1948,12,Great Britain,4,16,7,27,0,GBR
1948_ARG,1948,13,Argentina,3,3,1,7,0,ARG
1948_AUS,1948,14,Australia,2,6,5,13,0,AUS
1948_BEL,1948,15,Belgium,2,2,3,7,0,BEL
1948_RSA,1948,16,South Africa,2,2,2,6,0,RSA
1948_EGY,1948,17,Egypt,2,2,1,5,0,EGY
1948_MEX,1948,18,Mexico,2,1,2,5,0,MEX
1948_NOR,1948,19,Norway,1,3,3,7,0,NOR
1948_JAM,1948,20,Jamaica,1,2,0,3,0,JAM
1948_AUT,1948,21,Austria,1,0,3,4,0,AUT
1948_POL,1948,22,Poland,1,0,1,2,0,POL
1948_IND,1948,23,India,1,0,0,1,0,IND
1948_PER,1948,23,Peru,1,0,0,1,0,PER
1948_CAN,1948,25,Canada,0,2,2,4,0,CAN
1948_SRB,1948,26,Yugoslavia,0,2,0,2,0,SRB
1948_POR,1948,27,Portugal,0,1,1,2,0,POR
1948_URU,1948,27,Uruguay,0,1,1,2,0,URU
1948_SRI,1948,29,Ceylon,0,1,0,1,0,SRI
1948_CUB,1948,29,Cuba,0,1,0,1,0,CUB
1948_ESP,1948,29,Spain,0,1,0,1,0,ESP
1948_TTO,1948,29,Trinidad and Tobago,0,1,0,1,0,TTO
1948_PAN,1948,33,Panama,0,0,2,2,0,PAN
1948_KOR,1948,33,South Korea,0,0,2,2,0,KOR
1948_BRA,1948,35,Brazil,0,0,1,1,0,BRA
1948_IRI,1948,35,Iran,0,0,1,1,0,IRI
1948_IRL,1948,35,Ireland,0,0,1,1,0,IRL
1948_PUR,1948,35,Puerto Rico,0,0,1,1,0,PUR
1952_USA,1952,1,United States,40,19,17,76,0,USA
1952_RUS,1952,2,Soviet Union,22,30,19,71,0,RUS
1952_HUN,1952,3,Hungary,16,10,16,42,0,HUN
1952_SWE,1952,4,Sweden,12,13,10,35,0,SWE
1952_ITA,1952,5,Italy,8,9,4,21,0,ITA
1952_CZE,1952,6,Czechoslovakia,7,3,3,13,0,CZE
1952_FRA,1952,7,France,6,6,6,18,0,FRA
1952_FIN,1952,8,Finland,6,3,13,22,1,FIN
1952_AUS,1952,9,Australia,6,2,3,11,0,AUS
1952_NOR,1952,10,Norway,3,2,0,5,0,NOR
1952_SUI,1952,11,Switzerland,2,6,6,14,0,SUI
1952_RSA,1952,12,South Africa,2,4,4,10,0,RSA
1952_JAM,1952,13,Jamaica,2,3,0,5,0,JAM
1952_BEL,1952,14,Belgium,2,2,0,4,0,BEL
1952_DEN,1952,15,Denmark,2,1,3,6,0,DEN
1952_TUR,1952,16,Turkey,2,0,1,3,0,TUR
1952_JPN,1952,17,Japan,1,6,2,9,0,JPN
1952_GBR,1952,18,Great Britain,1,2,8,11,0,GBR
1952_ARG,1952,19,Argentina,1,2,2,5,0,ARG
1952_POL,1952,20,Poland,1,2,1,4,0,POL
1952_CAN,1952,21,Canada,1,2,0,3,0,CAN
1952_SRB,1952,21,Yugoslavia,1,2,0,3,0,SRB
1952_ROU,1952,23,Romania,1,1,2,4,0,ROU
1952_BRA,1952,24,Brazil,1,0,2,3,0,BRA
1952_NZL,1952,24,New Zealand,1,0,2,3,0,NZL
1952_IND,1952,26,India,1,0,1,2,0,IND
1952_LUX,1952,27,Luxembourg,1,0,0,1,0,LUX
1952_GER,1952,28,Germany,0,7,17,24,0,GER
1952_GER,1952,28,Germany,0,7,17,24,0,GER
1952_GER,1952,28,Germany,0,7,17,24,0,GER
1952_NED,1952,29,Netherlands,0,5,0,5,0,NED
1952_IRI,1952,30,Iran,0,3,4,7,0,IRI
1952_CHI,1952,31,Chile,0,2,0,2,0,CHI
1952_AUT,1952,32,Austria,0,1,1,2,0,AUT
1952_LIB,1952,32,Lebanon,0,1,1,2,0,LIB
1952_IRL,1952,34,Ireland,0,1,0,1,0,IRL
1952_MEX,1952,34,Mexico,0,1,0,1,0,MEX
1952_ESP,1952,34,Spain,0,1,0,1,0,ESP
1952_KOR,1952,37,South Korea,0,0,2,2,0,KOR
1952_TTO,1952,37,Trinidad and Tobago,0,0,2,2,0,TTO
1952_URU,1952,37,Uruguay,0,0,2,2,0,URU
1952_BUL,1952,40,Bulgaria,0,0,1,1,0,BUL
1952_EGY,1952,40,Egypt,0,0,1,1,0,EGY
1952_POR,1952,40,Portugal,0,0,1,1,0,POR
1952_VEN,1952,40,Venezuela,0,0,1,1,0,VEN
1956_RUS,1956,1,Soviet Union,37,29,32,98,0,RUS
1956_USA,1956,2,United States,32,25,17,74,0,USA
1956_AUS,1956,3,Australia,13,8,14,35,0,AUS
1956_HUN,1956,4,Hungary,9,10,7,26,0,HUN
1956_ITA,1956,5,Italy,8,8,9,25,1,ITA
1956_SWE,1956,6,Sweden,8,5,6,19,0,SWE
1956_GER,1956,7,United Team of Germany,6,13,7,26,0,GER
1956_GBR,1956,8,Great Britain,6,7,11,24,0,GBR
1956_ROU,1956,9,Romania,5,3,5,13,0,ROU
1956_JPN,1956,10,Japan,4,10,5,19,0,JPN
1956_FRA,1956,11,France,4,4,6,14,0,FRA
1956_TUR,1956,12,Turkey,3,2,2,7,0,TUR
1956_FIN,1956,13,Finland,3,1,11,15,0,FIN
1956_IRI,1956,14,Iran,2,2,1,5,0,IRI
1956_CAN,1956,15,Canada,2,1,3,6,0,CAN
1956_NZL,1956,16,New Zealand,2,0,0,2,0,NZL
1956_POL,1956,17,Poland,1,4,4,9,0,POL
1956_CZE,1956,18,Czechoslovakia,1,4,1,6,0,CZE
1956_BUL,1956,19,Bulgaria,1,3,1,5,0,BUL
1956_DEN,1956,20,Denmark,1,2,1,4,0,DEN
1956_IRL,1956,21,Ireland,1,1,3,5,0,IRL
1956_NOR,1956,22,Norway,1,0,2,3,0,NOR
1956_MEX,1956,23,Mexico,1,0,1,2,0,MEX
1956_BRA,1956,24,Brazil,1,0,0,1,0,BRA
1956_IND,1956,24,India,1,0,0,1,0,IND
1956_SRB,1956,26,Yugoslavia,0,3,0,3,0,SRB
1956_CHI,1956,27,Chile,0,2,2,4,0,CHI
1956_BEL,1956,28,Belgium,0,2,0,2,0,BEL
1956_ARG,1956,29,Argentina,0,1,1,2,0,ARG
1956_KOR,1956,29,South Korea,0,1,1,2,0,KOR
1956_ISL,1956,31,Iceland,0,1,0,1,0,ISL
1956_PAK,1956,31,Pakistan,0,1,0,1,0,PAK
1956_RSA,1956,33,South Africa,0,0,4,4,0,RSA
1956_AUT,1956,34,Austria,0,0,2,2,0,AUT
1956_BAH,1956,35,Bahamas,0,0,1,1,0,BAH
1956_GRE,1956,35,Greece,0,0,1,1,0,GRE
1956_SUI,1956,35,Switzerland,0,0,1,1,0,SUI
1956_URU,1956,35,Uruguay,0,0,1,1,0,URU
1964_USA,1964,1,United States,36,26,28,90,0,USA
1964_RUS,1964,2,Soviet Union,30,31,35,96,0,RUS
1964_JPN,1964,3,Japan,16,5,8,29,0,JPN
1964_GER,1964,4,United Team of Germany,10,22,18,50,0,GER
1964_ITA,1964,5,Italy,10,10,7,27,0,ITA
1964_HUN,1964,6,Hungary,10,7,5,22,0,HUN
1964_POL,1964,7,Poland,7,6,10,23,0,POL
1964_AUS,1964,8,Australia,6,2,10,18,0,AUS
1964_CZE,1964,9,Czechoslovakia,5,6,3,14,0,CZE
1964_GBR,1964,10,Great Britain,4,12,2,18,0,GBR
1964_BUL,1964,11,Bulgaria,3,5,2,10,0,BUL
1964_FIN,1964,12,Finland,3,0,2,5,0,FIN
1964_NZL,1964,12,New Zealand,3,0,2,5,0,NZL
1964_ROU,1964,14,Romania,2,4,6,12,0,ROU
1964_NED,1964,15,Netherlands,2,4,4,10,0,NED
1964_TUR,1964,16,Turkey,2,3,1,6,0,TUR
1964_SWE,1964,17,Sweden,2,2,4,8,0,SWE
1964_DEN,1964,18,Denmark,2,1,3,6,0,DEN
1964_SRB,1964,19,Yugoslavia,2,1,2,5,0,SRB
1964_BEL,1964,20,Belgium,2,0,1,3,0,BEL
1964_FRA,1964,21,France,1,8,6,15,0,FRA
1964_CAN,1964,22,Canada,1,2,1,4,0,CAN
1964_SUI,1964,22,Switzerland,1,2,1,4,0,SUI
1964_BAH,1964,24,Bahamas,1,0,0,1,0,BAH
1964_ETH,1964,24,Ethiopia,1,0,0,1,0,ETH
1964_IND,1964,24,India,1,0,0,1,0,IND
1964_KOR,1964,27,South Korea,0,2,1,3,0,KOR
1964_TTO,1964,28,Trinidad and Tobago,0,1,2,3,0,TTO
1964_TUN,1964,29,Tunisia,0,1,1,2,0,TUN
1964_ARG,1964,30,Argentina,0,1,0,1,0,ARG
1964_CUB,1964,30,Cuba,0,1,0,1,0,CUB
1964_PAK,1964,30,Pakistan,0,1,0,1,0,PAK
1964_PHI,1964,30,Philippines,0,1,0,1,0,PHI
1964_IRI,1964,34,Iran,0,0,2,2,0,IRI
1964_BRA,1964,35,Brazil,0,0,1,1,0,BRA
1964_GHA,1964,35,Ghana,0,0,1,1,0,GHA
1964_IRL,1964,35,Ireland,0,0,1,1,0,IRL
1964_KEN,1964,35,Kenya,0,0,1,1,0,KEN
1964_MEX,1964,35,Mexico,0,0,1,1,0,MEX
1964_NGR,1964,35,Nigeria,0,0,1,1,0,NGR
1964_URU,1964,35,Uruguay,0,0,1,1,0,URU
1968_USA,1968,1,United States,45,28,34,107,0,USA
1968_RUS,1968,2,Soviet Union,29,32,30,91,0,RUS
1968_JPN,1968,3,Japan,11,7,7,25,0,JPN
1968_HUN,1968,4,Hungary,10,10,12,32,0,HUN
1968_GER,1968,5,East Germany,9,9,7,25,0,GER
1968_FRA,1968,6,France,7,3,5,15,0,FRA
1968_CZE,1968,7,Czechoslovakia,7,2,4,13,0,CZE
1968_GER,1968,8,West Germany,5,11,10,26,0,GER
1968_AUS,1968,9,Australia,5,7,5,17,0,AUS
1968_GBR,1968,10,Great Britain,5,5,3,13,0,GBR
1968_POL,1968,11,Poland,5,2,11,18,0,POL
1968_ROU,1968,12,Romania,4,6,5,15,0,ROU
1968_ITA,1968,13,Italy,3,4,9,16,0,ITA
1968_KEN,1968,14,Kenya,3,4,2,9,0,KEN
1968_MEX,1968,15,Mexico,3,3,3,9,0,MEX
1968_SRB,1968,16,Yugoslavia,3,3,2,8,0,SRB
1968_NED,1968,17,Netherlands,3,3,1,7,0,NED
1968_BUL,1968,18,Bulgaria,2,4,3,9,0,BUL
1968_IRI,1968,19,Iran,2,1,2,5,0,IRI
1968_SWE,1968,20,Sweden,2,1,1,4,0,SWE
1968_TUR,1968,21,Turkey,2,0,0,2,0,TUR
1968_DEN,1968,22,Denmark,1,4,3,8,0,DEN
1968_CAN,1968,23,Canada,1,3,1,5,0,CAN
1968_FIN,1968,24,Finland,1,2,1,4,0,FIN
1968_ETH,1968,25,Ethiopia,1,1,0,2,0,ETH
1968_NOR,1968,25,Norway,1,1,0,2,0,NOR
1968_NZL,1968,27,New Zealand,1,0,2,3,0,NZL
1968_TUN,1968,28,Tunisia,1,0,1,2,0,TUN
1968_PAK,1968,29,Pakistan,1,0,0,1,0,PAK
1968_VEN,1968,29,Venezuela,1,0,0,1,0,VEN
1968_CUB,1968,31,Cuba,0,4,0,4,0,CUB
1968_AUT,1968,32,Austria,0,2,2,4,0,AUT
1968_SUI,1968,33,Switzerland,0,1,4,5,0,SUI
1968_MGL,1968,34,Mongolia,0,1,3,4,0,MGL
1968_BRA,1968,35,Brazil,0,1,2,3,0,BRA
1968_BEL,1968,36,Belgium,0,1,1,2,0,BEL
1968_KOR,1968,36,South Korea,0,1,1,2,0,KOR
1968_UGA,1968,36,Uganda,0,1,1,2,0,UGA
1968_CMR,1968,39,Cameroon,0,1,0,1,0,CMR
1968_JAM,1968,39,Jamaica,0,1,0,1,0,JAM
1968_ARG,1968,41,Argentina,0,0,2,2,0,ARG
1968_GRE,1968,42,Greece,0,0,1,1,0,GRE
1968_IND,1968,42,India,0,0,1,1,0,IND
1968_TPE,1968,42,Taiwan,0,0,1,1,0,TPE
1972_RUS,1972,1,Soviet Union,50,27,22,99,0,RUS
1972_USA,1972,2,United States,33,31,30,94,0,USA
1972_GER,1972,3,East Germany,20,23,23,66,0,GER
1972_GER,1972,4,West Germany,13,11,16,40,1,GER
1972_JPN,1972,5,Japan,13,8,8,29,1,JPN
1972_AUS,1972,6,Australia,8,7,2,17,0,AUS
1972_POL,1972,7,Poland,7,5,9,21,0,POL
1972_HUN,1972,8,Hungary,6,13,16,35,0,HUN
1972_BUL,1972,9,Bulgaria,6,10,5,21,0,BUL
1972_ITA,1972,10,Italy,5,3,10,18,0,ITA
1972_SWE,1972,11,Sweden,4,6,6,16,0,SWE
1972_GBR,1972,12,Great Britain,4,5,9,18,0,GBR
1972_ROU,1972,13,Romania,3,6,7,16,0,ROU
1972_CUB,1972,14,Cuba,3,1,4,8,0,CUB
1972_FIN,1972,14,Finland,3,1,4,8,0,FIN
1972_NED,1972,16,Netherlands,3,1,1,5,0,NED
1972_FRA,1972,17,France,2,4,7,13,0,FRA
1972_CZE,1972,18,Czechoslovakia,2,4,2,8,0,CZE
1972_KEN,1972,19,Kenya,2,3,4,9,0,KEN
1972_SRB,1972,20,Yugoslavia,2,1,2,5,0,SRB
1972_NOR,1972,21,Norway,2,1,1,4,0,NOR
1972_PRK,1972,22,North Korea,1,1,3,5,0,PRK
1972_NZL,1972,23,New Zealand,1,1,1,3,0,NZL
1972_UGA,1972,24,Uganda,1,1,0,2,0,UGA
1972_DEN,1972,25,Denmark,1,0,0,1,0,DEN
1972_SUI,1972,26,Switzerland,0,3,0,3,0,SUI
1972_CAN,1972,27,Canada,0,2,3,5,0,CAN
1972_IRI,1972,28,Iran,0,2,1,3,0,IRI
1972_BEL,1972,29,Belgium,0,2,0,2,0,BEL
1972_GRE,1972,29,Greece,0,2,0,2,0,GRE
1972_AUT,1972,31,Austria,0,1,2,3,0,AUT
1972_COL,1972,31,Colombia,0,1,2,3,0,COL
1972_ARG,1972,33,Argentina,0,1,0,1,0,ARG
1972_LIB,1972,33,Lebanon,0,1,0,1,0,LIB
1972_MEX,1972,33,Mexico,0,1,0,1,0,MEX
1972_MGL,1972,33,Mongolia,0,1,0,1,0,MGL
1972_PAK,1972,33,Pakistan,0,1,0,1,0,PAK
1972_KOR,1972,33,South Korea,0,1,0,1,0,KOR
1972_TUN,1972,33,Tunisia,0,1,0,1,0,TUN
1972_TUR,1972,33,Turkey,0,1,0,1,0,TUR
1972_BRA,1972,41,Brazil,0,0,2,2,0,BRA
1972_ETH,1972,41,Ethiopia,0,0,2,2,0,ETH
1972_GHA,1972,43,Ghana,0,0,1,1,0,GHA
1972_IND,1972,43,India,0,0,1,1,0,IND
1972_JAM,1972,43,Jamaica,0,0,1,1,0,JAM
1972_NIG,1972,43,Niger,0,0,1,1,0,NIG
1972_NGR,1972,43,Nigeria,0,0,1,1,0,NGR
1972_ESP,1972,43,Spain,0,0,1,1,0,ESP
1976_RUS,1976,1,Soviet Union,49,41,35,125,0,RUS
1976_GER,1976,2,East Germany,40,25,25,90,0,GER
1976_USA,1976,3,United States,34,35,25,94,0,USA
1976_GER,1976,4,West Germany,10,12,17,39,0,GER
1976_JPN,1976,5,Japan,9,6,10,25,0,JPN
1976_POL,1976,6,Poland,7,6,13,26,0,POL
1976_BUL,1976,7,Bulgaria,6,9,7,22,0,BUL
1976_CUB,1976,8,Cuba,6,4,3,13,0,CUB
1976_ROU,1976,9,Romania,4,9,14,27,0,ROU
1976_HUN,1976,10,Hungary,4,5,13,22,0,HUN
1976_FIN,1976,11,Finland,4,2,0,6,0,FIN
1976_SWE,1976,12,Sweden,4,1,0,5,0,SWE
1976_GBR,1976,13,Great Britain,3,5,5,13,0,GBR
1976_ITA,1976,14,Italy,2,7,4,13,0,ITA
1976_FRA,1976,15,France,2,3,4,9,0,FRA
1976_SRB,1976,16,Yugoslavia,2,3,3,8,0,SRB
1976_CZE,1976,17,Czechoslovakia,2,2,4,8,0,CZE
1976_NZL,1976,18,New Zealand,2,1,1,4,0,NZL
1976_KOR,1976,19,South Korea,1,1,4,6,0,KOR
1976_SUI,1976,20,Switzerland,1,1,2,4,0,SUI
1976_JAM,1976,21,Jamaica,1,1,0,2,0,JAM
1976_PRK,1976,21,North Korea,1,1,0,2,0,PRK
1976_NOR,1976,21,Norway,1,1,0,2,0,NOR
1976_DEN,1976,24,Denmark,1,0,2,3,0,DEN
1976_MEX,1976,25,Mexico,1,0,1,2,0,MEX
1976_TTO,1976,26,Trinidad and Tobago,1,0,0,1,0,TTO
1976_CAN,1976,27,Canada,0,5,6,11,0,CAN
1976_BEL,1976,28,Belgium,0,3,3,6,0,BEL
1976_NED,1976,29,Netherlands,0,2,3,5,0,NED
1976_POR,1976,30,Portugal,0,2,0,2,0,POR
1976_ESP,1976,30,Spain,0,2,0,2,0,ESP
1976_AUS,1976,32,Australia,0,1,4,5,0,AUS
1976_IRI,1976,33,Iran,0,1,1,2,0,IRI
1976_MGL,1976,34,Mongolia,0,1,0,1,0,MGL
1976_VEN,1976,34,Venezuela,0,1,0,1,0,VEN
1976_BRA,1976,36,Brazil,0,0,2,2,0,BRA
1976_AUT,1976,37,Austria,0,0,1,1,1,AUT
1976_BER,1976,37,Bermuda,0,0,1,1,0,BER
1976_PAK,1976,37,Pakistan,0,0,1,1,0,PAK
1976_PUR,1976,37,Puerto Rico,0,0,1,1,0,PUR
1976_THA,1976,37,Thailand,0,0,1,1,0,THA
1980_RUS,1980,1,Soviet Union,80,69,46,195,0,RUS
1980_GER,1980,2,East Germany,47,37,42,126,0,GER
1980_BUL,1980,3,Bulgaria,8,16,17,41,0,BUL
1980_CUB,1980,4,Cuba,8,7,5,20,0,CUB
1980_ITA,1980,5,Italy,8,3,4,15,0,ITA
1980_HUN,1980,6,Hungary,7,10,15,32,0,HUN
1980_ROU,1980,7,Romania,6,6,13,25,0,ROU
1980_FRA,1980,8,France,6,5,3,14,0,FRA
1980_GBR,1980,9,Great Britain,5,7,9,21,0,GBR
1980_POL,1980,10,Poland,3,14,15,32,0,POL
1980_SWE,1980,11,Sweden,3,3,6,12,0,SWE
1980_FIN,1980,12,Finland,3,1,4,8,0,FIN
1980_CZE,1980,13,Czechoslovakia,2,3,9,14,0,CZE
1980_SRB,1980,14,Yugoslavia,2,3,4,9,0,SRB
1980_AUS,1980,15,Australia,2,2,5,9,0,AUS
1980_DEN,1980,16,Denmark,2,1,2,5,0,DEN
1980_BRA,1980,17,Brazil,2,0,2,4,0,BRA
1980_ETH,1980,17,Ethiopia,2,0,2,4,0,ETH
1980_SUI,1980,19,Switzerland,2,0,0,2,0,SUI
1980_ESP,1980,20,Spain,1,3,2,6,0,ESP
1980_AUT,1980,21,Austria,1,2,1,4,0,AUT
1980_GRE,1980,22,Greece,1,0,2,3,0,GRE
1980_BEL,1980,23,Belgium,1,0,0,1,0,BEL
1980_IND,1980,23,India,1,0,0,1,0,IND
1980_ZIM,1980,23,Zimbabwe,1,0,0,1,0,ZIM
1980_PRK,1980,26,North Korea,0,3,2,5,0,PRK
1980_MGL,1980,27,Mongolia,0,2,2,4,0,MGL
1980_TAN,1980,28,Tanzania,0,2,0,2,0,TAN
1980_MEX,1980,29,Mexico,0,1,3,4,0,MEX
1980_NED,1980,30,Netherlands,0,1,2,3,0,NED
1980_IRL,1980,31,Ireland,0,1,1,2,0,IRL
1980_UGA,1980,32,Uganda,0,1,0,1,0,UGA
1980_VEN,1980,32,Venezuela,0,1,0,1,0,VEN
1980_JAM,1980,34,Jamaica,0,0,3,3,0,JAM
1980_GUY,1980,35,Guyana,0,0,1,1,0,GUY
1980_LIB,1980,35,Lebanon,0,0,1,1,0,LIB
1984_USA,1984,1,United States,83,61,30,174,0,USA
1984_ROU,1984,2,Romania,20,16,17,53,0,ROU
1984_GER,1984,3,West Germany,17,19,23,59,0,GER
1984_CHN,1984,4,China,15,8,9,32,0,CHN
1984_ITA,1984,5,Italy,14,6,12,32,0,ITA
1984_CAN,1984,6,Canada,10,18,16,44,0,CAN
1984_JPN,1984,7,Japan,10,8,14,32,0,JPN
1984_NZL,1984,8,New Zealand,8,1,2,11,0,NZL
1984_SRB,1984,9,Yugoslavia,7,4,7,18,1,SRB
1984_KOR,1984,10,South Korea,6,6,7,19,0,KOR
1984_GBR,1984,11,Great Britain,5,11,21,37,0,GBR
1984_FRA,1984,12,France,5,7,16,28,0,FRA
1984_NED,1984,13,Netherlands,5,2,6,13,0,NED
1984_AUS,1984,14,Australia,4,8,12,24,0,AUS
1984_FIN,1984,15,Finland,4,2,6,12,0,FIN
1984_SWE,1984,16,Sweden,2,11,6,19,0,SWE
1984_MEX,1984,17,Mexico,2,3,1,6,0,MEX
1984_MAR,1984,18,Morocco,2,0,0,2,0,MAR
1984_BRA,1984,19,Brazil,1,5,2,8,0,BRA
1984_ESP,1984,20,Spain,1,2,2,5,0,ESP
1984_BEL,1984,21,Belgium,1,1,2,4,0,BEL
1984_AUT,1984,22,Austria,1,1,1,3,0,AUT
1984_KEN,1984,23,Kenya,1,0,2,3,0,KEN
1984_POR,1984,23,Portugal,1,0,2,3,0,POR
1984_PAK,1984,25,Pakistan,1,0,0,1,0,PAK
1984_SUI,1984,26,Switzerland,0,4,4,8,0,SUI
1984_DEN,1984,27,Denmark,0,3,3,6,0,DEN
1984_JAM,1984,28,Jamaica,0,1,2,3,0,JAM
1984_NOR,1984,28,Norway,0,1,2,3,0,NOR
1984_GRE,1984,30,Greece,0,1,1,2,0,GRE
1984_NGR,1984,30,Nigeria,0,1,1,2,0,NGR
1984_PUR,1984,30,Puerto Rico,0,1,1,2,0,PUR
1984_COL,1984,33,Colombia,0,1,0,1,0,COL
1984_EGY,1984,33,Egypt,0,1,0,1,0,EGY
1984_IRL,1984,33,Ireland,0,1,0,1,0,IRL
1984_CIV,1984,33,Ivory Coast,0,1,0,1,0,CIV
1984_PER,1984,33,Peru,0,1,0,1,0,PER
1984_SYR,1984,33,Syria,0,1,0,1,0,SYR
1984_UAR,1984,33,Syria,0,1,0,1,0,UAR
1984_THA,1984,33,Thailand,0,1,0,1,0,THA
1984_TUR,1984,40,Turkey,0,0,3,3,0,TUR
1984_VEN,1984,40,Venezuela,0,0,3,3,0,VEN
1984_ALG,1984,42,Algeria,0,0,2,2,0,ALG
1984_CMR,1984,43,Cameroon,0,0,1,1,0,CMR
1984_Unknown,1984,43,Chinese Taipei,0,0,1,1,0,NA
1984_DOM,1984,43,Dominican Republic,0,0,1,1,0,DOM
1984_ISL,1984,43,Iceland,0,0,1,1,0,ISL
1984_ZAM,1984,43,Zambia,0,0,1,1,0,ZAM
1988_RUS,1988,1,Soviet Union,55,31,46,132,0,RUS
1988_GER,1988,2,East Germany,37,35,30,102,0,GER
1988_USA,1988,3,United States,36,31,27,94,0,USA
1988_KOR,1988,4,South Korea,12,10,11,33,1,KOR
1988_GER,1988,5,West Germany,11,14,15,40,0,GER
1988_HUN,1988,6,Hungary,11,6,6,23,0,HUN
1988_BUL,1988,7,Bulgaria,10,12,13,35,0,BUL
1988_ROU,1988,8,Romania,7,11,6,24,0,ROU
1988_FRA,1988,9,France,6,4,6,16,0,FRA
1988_ITA,1988,10,Italy,6,4,4,14,0,ITA
1988_CHN,1988,11,China,5,11,12,28,0,CHN
1988_GBR,1988,12,Great Britain,5,10,9,24,0,GBR
1988_KEN,1988,13,Kenya,5,2,2,9,0,KEN
1988_JPN,1988,14,Japan,4,3,7,14,0,JPN
1988_AUS,1988,15,Australia,3,6,5,14,0,AUS
1988_SRB,1988,16,Yugoslavia,3,4,5,12,0,SRB
1988_CZE,1988,17,Czechoslovakia,3,3,2,8,0,CZE
1988_NZL,1988,18,New Zealand,3,2,8,13,0,NZL
1988_CAN,1988,19,Canada,3,2,5,10,1,CAN
1988_POL,1988,20,Poland,2,5,9,16,0,POL
1988_NOR,1988,21,Norway,2,3,0,5,0,NOR
1988_NED,1988,22,Netherlands,2,2,5,9,0,NED
1988_DEN,1988,23,Denmark,2,1,1,4,0,DEN
1988_BRA,1988,24,Brazil,1,2,3,6,0,BRA
1988_FIN,1988,25,Finland,1,1,2,4,0,FIN
1988_ESP,1988,25,Spain,1,1,2,4,0,ESP
1988_TUR,1988,27,Turkey,1,1,0,2,0,TUR
1988_MAR,1988,28,Morocco,1,0,2,3,0,MAR
1988_AUT,1988,29,Austria,1,0,0,1,0,AUT
1988_POR,1988,29,Portugal,1,0,0,1,0,POR
1988_SUR,1988,29,Suriname,1,0,0,1,0,SUR
1988_SWE,1988,32,Sweden,0,4,7,11,0,SWE
1988_SUI,1988,33,Switzerland,0,2,2,4,0,SUI
1988_JAM,1988,34,Jamaica,0,2,0,2,0,JAM
1988_ARG,1988,35,Argentina,0,1,1,2,0,ARG
1988_CHI,1988,36,Chile,0,1,0,1,0,CHI
1988_CRC,1988,36,Costa Rica,0,1,0,1,0,CRC
1988_INA,1988,36,Indonesia,0,1,0,1,0,INA
1988_IRI,1988,36,Iran,0,1,0,1,0,IRI
1988_AHO,1988,36,Netherlands Antilles,0,1,0,1,0,AHO
1988_PER,1988,36,Peru,0,1,0,1,0,PER
1988_SEN,1988,36,Senegal,0,1,0,1,0,SEN
1988_ISV,1988,36,Virgin Islands,0,1,0,1,0,ISV
1988_BEL,1988,44,Belgium,0,0,2,2,0,BEL
1988_MEX,1988,44,Mexico,0,0,2,2,0,MEX
1988_COL,1988,46,Colombia,0,0,1,1,0,COL
1988_DJI,1988,46,Djibouti,0,0,1,1,0,DJI
1988_GRE,1988,46,Greece,0,0,1,1,0,GRE
1988_MGL,1988,46,Mongolia,0,0,1,1,0,MGL
1988_PAK,1988,46,Pakistan,0,0,1,1,0,PAK
1988_PHI,1988,46,Philippines,0,0,1,1,0,PHI
1988_THA,1988,46,Thailand,0,0,1,1,0,THA
1992_Unknown,1992,1,Unified Team,45,38,29,112,0,NA
1992_USA,1992,2,United States,37,34,37,108,0,USA
1992_GER,1992,3,Germany,33,21,28,82,0,GER
1992_GER,1992,3,Germany,33,21,28,82,0,GER
1992_GER,1992,3,Germany,33,21,28,82,0,GER
1992_CHN,1992,4,China,16,22,16,54,0,CHN
1992_CUB,1992,5,Cuba,14,6,11,31,0,CUB
1992_ESP,1992,6,Spain,13,7,2,22,1,ESP
1992_KOR,1992,7,South Korea,12,5,12,29,0,KOR
1992_HUN,1992,8,Hungary,11,12,7,30,0,HUN
1992_FRA,1992,9,France,8,5,16,29,1,FRA
1992_AUS,1992,10,Australia,7,9,11,27,0,AUS
1992_CAN,1992,11,Canada,7,4,7,18,0,CAN
1992_ITA,1992,12,Italy,6,5,8,19,0,ITA
1992_GBR,1992,13,Great Britain,5,3,12,20,0,GBR
1992_ROU,1992,14,Romania,4,6,8,18,0,ROU
1992_CZE,1992,15,Czechoslovakia,4,2,1,7,0,CZE
1992_PRK,1992,16,North Korea,4,0,5,9,0,PRK
1992_JPN,1992,17,Japan,3,8,11,22,0,JPN
1992_BUL,1992,18,Bulgaria,3,7,6,16,0,BUL
1992_POL,1992,19,Poland,3,6,10,19,0,POL
1992_NED,1992,20,Netherlands,2,6,7,15,0,NED
1992_KEN,1992,21,Kenya,2,4,2,8,0,KEN
1992_NOR,1992,22,Norway,2,4,1,7,0,NOR
1992_TUR,1992,23,Turkey,2,2,2,6,0,TUR
1992_INA,1992,24,Indonesia,2,2,1,5,0,INA
1992_BRA,1992,25,Brazil,2,1,0,3,0,BRA
1992_GRE,1992,26,Greece,2,0,0,2,0,GRE
1992_SWE,1992,27,Sweden,1,7,4,12,0,SWE
1992_NZL,1992,28,New Zealand,1,4,5,10,0,NZL
1992_FIN,1992,29,Finland,1,2,2,5,0,FIN
1992_DEN,1992,30,Denmark,1,1,4,6,0,DEN
1992_MAR,1992,31,Morocco,1,1,1,3,0,MAR
1992_IRL,1992,32,Ireland,1,1,0,2,0,IRL
1992_ETH,1992,33,Ethiopia,1,0,2,3,0,ETH
1992_ALG,1992,34,Algeria,1,0,1,2,0,ALG
1992_EST,1992,34,Estonia,1,0,1,2,0,EST
1992_LTU,1992,34,Lithuania,1,0,1,2,0,LTU
1992_SUI,1992,37,Switzerland,1,0,0,1,0,SUI
1992_JAM,1992,38,Jamaica,0,3,1,4,0,JAM
1992_NGR,1992,38,Nigeria,0,3,1,4,0,NGR
1992_LAT,1992,40,Latvia,0,2,1,3,0,LAT
1992_AUT,1992,41,Austria,0,2,0,2,0,AUT
1992_NAM,1992,41,Namibia,0,2,0,2,0,NAM
1992_RSA,1992,41,South Africa,0,2,0,2,0,RSA
1992_BEL,1992,44,Belgium,0,1,2,3,0,BEL
1992_CRO,1992,44,Croatia,0,1,2,3,0,CRO
1992_Unknown,1992,44,Independent Olympic Participants,0,1,2,3,0,NA
1992_IRI,1992,44,Iran,0,1,2,3,0,IRI
1992_ISR,1992,48,Israel,0,1,1,2,0,ISR
1992_Unknown,1992,49,Chinese Taipei,0,1,0,1,0,NA
1992_MEX,1992,49,Mexico,0,1,0,1,0,MEX
1992_PER,1992,49,Peru,0,1,0,1,0,PER
1992_MGL,1992,52,Mongolia,0,0,2,2,0,MGL
1992_SLO,1992,52,Slovenia,0,0,2,2,0,SLO
1992_ARG,1992,54,Argentina,0,0,1,1,0,ARG
1992_BAH,1992,54,Bahamas,0,0,1,1,0,BAH
1992_COL,1992,54,Colombia,0,0,1,1,0,COL
1992_GHA,1992,54,Ghana,0,0,1,1,0,GHA
1992_MAS,1992,54,Malaysia,0,0,1,1,0,MAS
1992_PAK,1992,54,Pakistan,0,0,1,1,0,PAK
1992_PHI,1992,54,Philippines,0,0,1,1,0,PHI
1992_PUR,1992,54,Puerto Rico,0,0,1,1,0,PUR
1992_QAT,1992,54,Qatar,0,0,1,1,0,QAT
1992_SUR,1992,54,Suriname,0,0,1,1,0,SUR
1992_THA,1992,54,Thailand,0,0,1,1,0,THA
1996_USA,1996,1,United States,44,32,25,101,1,USA
1996_RUS,1996,2,Russia,26,21,16,63,0,RUS
1996_RUS,1996,2,Russia,26,21,16,63,0,RUS
1996_GER,1996,3,Germany,20,18,27,65,0,GER
1996_GER,1996,3,Germany,20,18,27,65,0,GER
1996_GER,1996,3,Germany,20,18,27,65,0,GER
1996_CHN,1996,4,China,16,22,12,50,0,CHN
1996_FRA,1996,5,France,15,7,15,37,0,FRA
1996_ITA,1996,6,Italy,13,10,12,35,0,ITA
1996_AUS,1996,7,Australia,9,9,23,41,0,AUS
1996_CUB,1996,8,Cuba,9,8,8,25,0,CUB
1996_UKR,1996,9,Ukraine,9,2,12,23,0,UKR
1996_KOR,1996,10,South Korea,7,15,5,27,0,KOR
1996_POL,1996,11,Poland,7,5,5,17,0,POL
1996_HUN,1996,12,Hungary,7,4,10,21,0,HUN
1996_ESP,1996,13,Spain,5,6,6,17,0,ESP
1996_ROU,1996,14,Romania,4,7,9,20,0,ROU
1996_NED,1996,15,Netherlands,4,5,10,19,0,NED
1996_GRE,1996,16,Greece,4,4,0,8,0,GRE
1996_CZE,1996,17,Czech Republic,4,3,4,11,0,CZE
1996_CZE,1996,17,Czech Republic,4,3,4,11,0,CZE
1996_SUI,1996,18,Switzerland,4,3,0,7,0,SUI
1996_DEN,1996,19,Denmark,4,1,1,6,0,DEN
1996_TUR,1996,19,Turkey,4,1,1,6,0,TUR
1996_CAN,1996,21,Canada,3,11,8,22,0,CAN
1996_BUL,1996,22,Bulgaria,3,7,5,15,0,BUL
1996_JPN,1996,23,Japan,3,6,5,14,0,JPN
1996_KAZ,1996,24,Kazakhstan,3,4,4,11,0,KAZ
1996_BRA,1996,25,Brazil,3,3,9,15,0,BRA
1996_NZL,1996,26,New Zealand,3,2,1,6,0,NZL
1996_RSA,1996,27,South Africa,3,1,1,5,0,RSA
1996_IRL,1996,28,Ireland,3,0,1,4,0,IRL
1996_SWE,1996,29,Sweden,2,4,2,8,0,SWE
1996_NOR,1996,30,Norway,2,2,3,7,0,NOR
1996_BEL,1996,31,Belgium,2,2,2,6,0,BEL
1996_NGR,1996,32,Nigeria,2,1,3,6,0,NGR
1996_PRK,1996,33,North Korea,2,1,2,5,0,PRK
1996_ALG,1996,34,Algeria,2,0,1,3,0,ALG
1996_ETH,1996,34,Ethiopia,2,0,1,3,0,ETH
1996_GBR,1996,36,Great Britain,1,8,6,15,0,GBR
1996_BLR,1996,37,Belarus,1,6,8,15,0,BLR
1996_KEN,1996,38,Kenya,1,4,3,8,0,KEN
1996_JAM,1996,39,Jamaica,1,3,2,6,0,JAM
1996_FIN,1996,40,Finland,1,2,1,4,0,FIN
1996_Unknown,1996,41,FR Yugoslavia,1,1,2,4,0,NA
1996_INA,1996,41,Indonesia,1,1,2,4,0,INA
1996_IRI,1996,43,Iran,1,1,1,3,0,IRI
1996_SVK,1996,43,Slovakia,1,1,1,3,0,SVK
1996_ARM,1996,45,Armenia,1,1,0,2,0,ARM
1996_CRO,1996,45,Croatia,1,1,0,2,0,CRO
1996_POR,1996,47,Portugal,1,0,1,2,0,POR
1996_THA,1996,47,Thailand,1,0,1,2,0,THA
1996_BDI,1996,49,Burundi,1,0,0,1,0,BDI
1996_CRC,1996,49,Costa Rica,1,0,0,1,0,CRC
1996_ECU,1996,49,Ecuador,1,0,0,1,0,ECU
1996_Unknown,1996,49,Hong Kong,1,0,0,1,0,NA
1996_SYR,1996,49,Syria,1,0,0,1,0,SYR
1996_UAR,1996,49,Syria,1,0,0,1,0,UAR
1996_ARG,1996,54,Argentina,0,2,1,3,0,ARG
1996_NAM,1996,55,Namibia,0,2,0,2,0,NAM
1996_SLO,1996,55,Slovenia,0,2,0,2,0,SLO
1996_AUT,1996,57,Austria,0,1,2,3,0,AUT
1996_MAS,1996,58,Malaysia,0,1,1,2,0,MAS
1996_MDA,1996,58,Moldova,0,1,1,2,0,MDA
1996_UZB,1996,58,Uzbekistan,0,1,1,2,0,UZB
1996_AZE,1996,61,Azerbaijan,0,1,0,1,0,AZE
1996_BAH,1996,61,Bahamas,0,1,0,1,0,BAH
1996_Unknown,1996,61,Chinese Taipei,0,1,0,1,0,NA
1996_LAT,1996,61,Latvia,0,1,0,1,0,LAT
1996_PHI,1996,61,Philippines,0,1,0,1,0,PHI
1996_TGA,1996,61,Tonga,0,1,0,1,0,TGA
1996_ZAM,1996,61,Zambia,0,1,0,1,0,ZAM
1996_GEO,1996,68,Georgia,0,0,2,2,0,GEO
1996_MAR,1996,68,Morocco,0,0,2,2,0,MAR
1996_TTO,1996,68,Trinidad and Tobago,0,0,2,2,0,TTO
1996_IND,1996,71,India,0,0,1,1,0,IND
1996_ISR,1996,71,Israel,0,0,1,1,0,ISR
1996_LTU,1996,71,Lithuania,0,0,1,1,0,LTU
1996_MEX,1996,71,Mexico,0,0,1,1,0,MEX
1996_MGL,1996,71,Mongolia,0,0,1,1,0,MGL
1996_MOZ,1996,71,Mozambique,0,0,1,1,0,MOZ
1996_PUR,1996,71,Puerto Rico,0,0,1,1,0,PUR
1996_TUN,1996,71,Tunisia,0,0,1,1,0,TUN
1996_UGA,1996,71,Uganda,0,0,1,1,0,UGA
2000_USA,2000,1,United States,37,24,32,93,0,USA
2000_RUS,2000,2,Russia,32,28,29,89,0,RUS
2000_RUS,2000,2,Russia,32,28,29,89,0,RUS
2000_CHN,2000,3,China,28,16,14,58,0,CHN
2000_AUS,2000,4,Australia,16,25,17,58,1,AUS
2000_GER,2000,5,Germany,13,17,26,56,0,GER
2000_GER,2000,5,Germany,13,17,26,56,0,GER
2000_GER,2000,5,Germany,13,17,26,56,0,GER
2000_FRA,2000,6,France,13,14,11,38,0,FRA
2000_ITA,2000,7,Italy,13,8,13,34,0,ITA
2000_NED,2000,8,Netherlands,12,9,4,25,0,NED
2000_CUB,2000,9,Cuba,11,11,7,29,0,CUB
2000_GBR,2000,10,Great Britain,11,10,7,28,0,GBR
2000_ROU,2000,11,Romania,11,6,9,26,0,ROU
2000_KOR,2000,12,South Korea,8,10,10,28,0,KOR
2000_HUN,2000,13,Hungary,8,6,3,17,0,HUN
2000_POL,2000,14,Poland,6,5,3,14,0,POL
2000_JPN,2000,15,Japan,5,8,5,18,0,JPN
2000_BUL,2000,16,Bulgaria,5,6,2,13,0,BUL
2000_GRE,2000,17,Greece,4,6,3,13,0,GRE
2000_SWE,2000,18,Sweden,4,5,3,12,0,SWE
2000_NOR,2000,19,Norway,4,3,3,10,0,NOR
2000_ETH,2000,20,Ethiopia,4,1,3,8,0,ETH
2000_UKR,2000,21,Ukraine,3,10,10,23,0,UKR
2000_KAZ,2000,22,Kazakhstan,3,4,0,7,0,KAZ
2000_BLR,2000,23,Belarus,3,3,11,17,0,BLR
2000_CAN,2000,24,Canada,3,3,8,14,0,CAN
2000_ESP,2000,25,Spain,3,3,5,11,0,ESP
2000_TUR,2000,26,Turkey,3,0,2,5,0,TUR
2000_IRI,2000,27,Iran,3,0,1,4,0,IRI
2000_CZE,2000,28,Czech Republic,2,3,3,8,0,CZE
2000_CZE,2000,28,Czech Republic,2,3,3,8,0,CZE
2000_KEN,2000,29,Kenya,2,3,2,7,0,KEN
2000_DEN,2000,30,Denmark,2,3,1,6,0,DEN
2000_FIN,2000,31,Finland,2,1,1,4,0,FIN
2000_AUT,2000,32,Austria,2,1,0,3,0,AUT
2000_LTU,2000,33,Lithuania,2,0,3,5,0,LTU
2000_AZE,2000,34,Azerbaijan,2,0,1,3,0,AZE
2000_BAH,2000,34,Bahamas,2,0,1,3,0,BAH
2000_SLO,2000,36,Slovenia,2,0,0,2,0,SLO
2000_SUI,2000,37,Switzerland,1,6,2,9,0,SUI
2000_INA,2000,38,Indonesia,1,3,2,6,0,INA
2000_SVK,2000,39,Slovakia,1,3,1,5,0,SVK
2000_MEX,2000,40,Mexico,1,2,3,6,0,MEX
2000_NGR,2000,41,Nigeria,1,2,0,3,0,NGR
2000_ALG,2000,42,Algeria,1,1,3,5,0,ALG
2000_UZB,2000,43,Uzbekistan,1,1,2,4,0,UZB
2000_Unknown,2000,44,FR Yugoslavia,1,1,1,3,0,NA
2000_LAT,2000,44,Latvia,1,1,1,3,0,LAT
2000_NZL,2000,46,New Zealand,1,0,3,4,0,NZL
2000_EST,2000,47,Estonia,1,0,2,3,0,EST
2000_THA,2000,47,Thailand,1,0,2,3,0,THA
2000_CRO,2000,49,Croatia,1,0,1,2,0,CRO
2000_CMR,2000,50,Cameroon,1,0,0,1,0,CMR
2000_COL,2000,50,Colombia,1,0,0,1,0,COL
2000_MOZ,2000,50,Mozambique,1,0,0,1,0,MOZ
2000_BRA,2000,53,Brazil,0,6,6,12,0,BRA
2000_JAM,2000,54,Jamaica,0,6,3,9,0,JAM
2000_BEL,2000,55,Belgium,0,2,3,5,0,BEL
2000_RSA,2000,55,South Africa,0,2,3,5,0,RSA
2000_ARG,2000,57,Argentina,0,2,2,4,0,ARG
2000_Unknown,2000,58,Chinese Taipei,0,1,4,5,0,NA
2000_MAR,2000,58,Morocco,0,1,4,5,0,MAR
2000_PRK,2000,60,North Korea,0,1,3,4,0,PRK
2000_MDA,2000,61,Moldova,0,1,1,2,0,MDA
2000_KSA,2000,61,Saudi Arabia,0,1,1,2,0,KSA
2000_TTO,2000,61,Trinidad and Tobago,0,1,1,2,0,TTO
2000_IRL,2000,64,Ireland,0,1,0,1,0,IRL
2000_SRI,2000,64,Sri Lanka,0,1,0,1,0,SRI
2000_URU,2000,64,Uruguay,0,1,0,1,0,URU
2000_VIE,2000,64,Vietnam,0,1,0,1,0,VIE
2000_GEO,2000,68,Georgia,0,0,6,6,0,GEO
2000_CRC,2000,69,Costa Rica,0,0,2,2,0,CRC
2000_POR,2000,69,Portugal,0,0,2,2,0,POR
2000_ARM,2000,71,Armenia,0,0,1,1,0,ARM
2000_BAR,2000,71,Barbados,0,0,1,1,0,BAR
2000_CHI,2000,71,Chile,0,0,1,1,0,CHI
2000_ISL,2000,71,Iceland,0,0,1,1,0,ISL
2000_IND,2000,71,India,0,0,1,1,0,IND
2000_ISR,2000,71,Israel,0,0,1,1,0,ISR
2000_KUW,2000,71,Kuwait,0,0,1,1,0,KUW
2000_KGZ,2000,71,Kyrgyzstan,0,0,1,1,0,KGZ
2000_MKD,2000,71,Macedonia,0,0,1,1,0,MKD
2000_QAT,2000,71,Qatar,0,0,1,1,0,QAT
2004_USA,2004,1,United States,36,39,26,101,0,USA
2004_CHN,2004,2,China,32,17,14,63,0,CHN
2004_RUS,2004,3,Russia,28,26,36,90,0,RUS
2004_RUS,2004,3,Russia,28,26,36,90,0,RUS
2004_AUS,2004,4,Australia,17,16,17,50,0,AUS
2004_JPN,2004,5,Japan,16,9,12,37,0,JPN
2004_GER,2004,6,Germany,13,16,20,49,0,GER
2004_GER,2004,6,Germany,13,16,20,49,0,GER
2004_GER,2004,6,Germany,13,16,20,49,0,GER
2004_FRA,2004,7,France,11,9,13,33,0,FRA
2004_ITA,2004,8,Italy,10,11,11,32,0,ITA
2004_KOR,2004,9,South Korea,9,12,9,30,0,KOR
2004_GBR,2004,10,Great Britain,9,9,12,30,0,GBR
2004_CUB,2004,11,Cuba,9,7,11,27,0,CUB
2004_HUN,2004,12,Hungary,8,6,3,17,0,HUN
2004_UKR,2004,13,Ukraine,8,5,9,22,0,UKR
2004_ROU,2004,14,Romania,8,5,6,19,0,ROU
2004_GRE,2004,15,Greece,6,6,4,16,1,GRE
2004_BRA,2004,16,Brazil,5,2,3,10,0,BRA
2004_NOR,2004,17,Norway,5,0,1,6,0,NOR
2004_NED,2004,18,Netherlands,4,9,9,22,0,NED
2004_SWE,2004,19,Sweden,4,2,1,7,0,SWE
2004_ESP,2004,20,Spain,3,11,6,20,0,ESP
2004_CAN,2004,21,Canada,3,6,3,12,0,CAN
2004_TUR,2004,22,Turkey,3,3,4,10,0,TUR
2004_POL,2004,23,Poland,3,2,5,10,0,POL
2004_NZL,2004,24,New Zealand,3,2,0,5,0,NZL
2004_THA,2004,25,Thailand,3,1,4,8,0,THA
2004_BLR,2004,26,Belarus,2,5,6,13,0,BLR
2004_AUT,2004,27,Austria,2,4,1,7,0,AUT
2004_ETH,2004,28,Ethiopia,2,3,2,7,0,ETH
2004_IRI,2004,29,Iran,2,2,2,6,0,IRI
2004_SVK,2004,29,Slovakia,2,2,2,6,0,SVK
2004_Unknown,2004,31,Chinese Taipei,2,2,1,5,0,NA
2004_GEO,2004,32,Georgia,2,2,0,4,0,GEO
2004_BUL,2004,33,Bulgaria,2,1,9,12,0,BUL
2004_DEN,2004,34,Denmark,2,1,5,8,0,DEN
2004_JAM,2004,35,Jamaica,2,1,2,5,0,JAM
2004_UZB,2004,35,Uzbekistan,2,1,2,5,0,UZB
2004_MAR,2004,37,Morocco,2,1,0,3,0,MAR
2004_ARG,2004,38,Argentina,2,0,4,6,0,ARG
2004_CHI,2004,39,Chile,2,0,1,3,0,CHI
2004_KAZ,2004,40,Kazakhstan,1,4,3,8,0,KAZ
2004_KEN,2004,41,Kenya,1,4,2,7,0,KEN
2004_CZE,2004,42,Czech Republic,1,3,5,9,0,CZE
2004_CZE,2004,42,Czech Republic,1,3,5,9,0,CZE
2004_RSA,2004,43,South Africa,1,3,2,6,0,RSA
2004_CRO,2004,44,Croatia,1,2,2,5,0,CRO
2004_LTU,2004,45,Lithuania,1,2,0,3,0,LTU
2004_EGY,2004,46,Egypt,1,1,3,5,0,EGY
2004_SUI,2004,46,Switzerland,1,1,3,5,0,SUI
2004_INA,2004,48,Indonesia,1,1,2,4,0,INA
2004_ZIM,2004,49,Zimbabwe,1,1,1,3,0,ZIM
2004_AZE,2004,50,Azerbaijan,1,0,4,5,0,AZE
2004_BEL,2004,51,Belgium,1,0,2,3,0,BEL
2004_BAH,2004,52,Bahamas,1,0,1,2,0,BAH
2004_ISR,2004,52,Israel,1,0,1,2,0,ISR
2004_CMR,2004,54,Cameroon,1,0,0,1,0,CMR
2004_DOM,2004,54,Dominican Republic,1,0,0,1,0,DOM
2004_UAE,2004,54,United Arab Emirates,1,0,0,1,0,UAE
2004_PRK,2004,57,North Korea,0,4,1,5,0,PRK
2004_LAT,2004,58,Latvia,0,4,0,4,0,LAT
2004_MEX,2004,59,Mexico,0,3,1,4,0,MEX
2004_POR,2004,60,Portugal,0,2,1,3,0,POR
2004_FIN,2004,61,Finland,0,2,0,2,0,FIN
2004_Unknown,2004,61,Serbia and Montenegro,0,2,0,2,0,NA
2004_SLO,2004,63,Slovenia,0,1,3,4,0,SLO
2004_EST,2004,64,Estonia,0,1,2,3,0,EST
2004_Unknown,2004,65,Hong Kong,0,1,0,1,0,NA
2004_IND,2004,65,India,0,1,0,1,0,IND
2004_PAR,2004,65,Paraguay,0,1,0,1,0,PAR
2004_COL,2004,68,Colombia,0,0,2,2,0,COL
2004_NGR,2004,68,Nigeria,0,0,2,2,0,NGR
2004_VEN,2004,68,Venezuela,0,0,2,2,0,VEN
2004_ERI,2004,71,Eritrea,0,0,1,1,0,ERI
2004_MGL,2004,71,Mongolia,0,0,1,1,0,MGL
2004_SYR,2004,71,Syria,0,0,1,1,0,SYR
2004_UAR,2004,71,Syria,0,0,1,1,0,UAR
2004_TTO,2004,71,Trinidad and Tobago,0,0,1,1,0,TTO
2008_CHN,2008,1,China,48,22,30,100,1,CHN
2008_USA,2008,2,United States,36,39,37,112,0,USA
2008_RUS,2008,3,Russia,24,13,23,60,0,RUS
2008_RUS,2008,3,Russia,24,13,23,60,0,RUS
2008_GBR,2008,4,Great Britain,19,13,19,51,0,GBR
2008_GER,2008,5,Germany,16,11,14,41,0,GER
2008_GER,2008,5,Germany,16,11,14,41,0,GER
2008_GER,2008,5,Germany,16,11,14,41,0,GER
2008_AUS,2008,6,Australia,14,15,17,46,0,AUS
2008_KOR,2008,7,South Korea,13,11,8,32,0,KOR
2008_JPN,2008,8,Japan,9,8,8,25,0,JPN
2008_ITA,2008,9,Italy,8,9,10,27,0,ITA
2008_FRA,2008,10,France,7,16,20,43,0,FRA
2008_NED,2008,11,Netherlands,7,5,4,16,0,NED
2008_UKR,2008,12,Ukraine,7,4,11,22,0,UKR
2008_KEN,2008,13,Kenya,6,4,6,16,0,KEN
2008_ESP,2008,14,Spain,5,11,3,19,0,ESP
2008_JAM,2008,15,Jamaica,5,4,2,11,0,JAM
2008_POL,2008,16,Poland,4,5,2,11,0,POL
2008_ETH,2008,17,Ethiopia,4,2,1,7,0,ETH
2008_ROU,2008,18,Romania,4,1,4,9,0,ROU
2008_CUB,2008,19,Cuba,3,10,17,30,0,CUB
2008_CAN,2008,20,Canada,3,9,8,20,0,CAN
2008_HUN,2008,21,Hungary,3,5,2,10,0,HUN
2008_NOR,2008,22,Norway,3,5,1,9,0,NOR
2008_BRA,2008,23,Brazil,3,4,10,17,0,BRA
2008_BLR,2008,24,Belarus,3,4,7,14,0,BLR
2008_CZE,2008,25,Czech Republic,3,3,1,7,0,CZE
2008_CZE,2008,25,Czech Republic,3,3,1,7,0,CZE
2008_SVK,2008,26,Slovakia,3,3,0,6,0,SVK
2008_NZL,2008,27,New Zealand,3,2,4,9,0,NZL
2008_GEO,2008,28,Georgia,3,2,2,7,0,GEO
2008_KAZ,2008,29,Kazakhstan,2,3,4,9,0,KAZ
2008_DEN,2008,30,Denmark,2,2,3,7,0,DEN
2008_PRK,2008,31,North Korea,2,2,2,6,0,PRK
2008_THA,2008,31,Thailand,2,2,2,6,0,THA
2008_MGL,2008,33,Mongolia,2,2,0,4,0,MGL
2008_SUI,2008,34,Switzerland,2,1,4,7,0,SUI
2008_ARG,2008,35,Argentina,2,0,4,6,0,ARG
2008_MEX,2008,36,Mexico,2,0,2,4,0,MEX
2008_BEL,2008,37,Belgium,2,0,0,2,0,BEL
2008_ZIM,2008,38,Zimbabwe,1,3,0,4,0,ZIM
2008_SLO,2008,39,Slovenia,1,2,2,5,0,SLO
2008_AZE,2008,40,Azerbaijan,1,1,4,6,0,AZE
2008_INA,2008,40,Indonesia,1,1,4,6,0,INA
2008_BUL,2008,42,Bulgaria,1,1,3,5,0,BUL
2008_TUR,2008,42,Turkey,1,1,3,5,0,TUR
2008_Unknown,2008,44,Chinese Taipei,1,1,2,4,0,NA
2008_FIN,2008,44,Finland,1,1,2,4,0,FIN
2008_LAT,2008,46,Latvia,1,1,1,3,0,LAT
2008_DOM,2008,47,Dominican Republic,1,1,0,2,0,DOM
2008_EST,2008,47,Estonia,1,1,0,2,0,EST
2008_POR,2008,47,Portugal,1,1,0,2,0,POR
2008_TTO,2008,47,Trinidad and Tobago,1,1,0,2,0,TTO
2008_IND,2008,51,India,1,0,2,3,0,IND
2008_IRI,2008,52,Iran,1,0,1,2,0,IRI
2008_CMR,2008,53,Cameroon,1,0,0,1,0,CMR
2008_PAN,2008,53,Panama,1,0,0,1,0,PAN
2008_TUN,2008,53,Tunisia,1,0,0,1,0,TUN
2008_SWE,2008,56,Sweden,0,4,1,5,0,SWE
2008_LTU,2008,57,Lithuania,0,3,2,5,0,LTU
2008_NGR,2008,57,Nigeria,0,3,2,5,0,NGR
2008_CRO,2008,59,Croatia,0,2,3,5,0,CRO
2008_COL,2008,60,Colombia,0,2,1,3,0,COL
2008_GRE,2008,60,Greece,0,2,1,3,0,GRE
2008_ARM,2008,62,Armenia,0,1,4,5,0,ARM
2008_UZB,2008,63,Uzbekistan,0,1,3,4,0,UZB
2008_AUT,2008,64,Austria,0,1,2,3,0,AUT
2008_IRL,2008,64,Ireland,0,1,2,3,0,IRL
2008_KGZ,2008,64,Kyrgyzstan,0,1,2,3,0,KGZ
2008_SRB,2008,64,Serbia,0,1,2,3,0,SRB
2008_ALG,2008,68,Algeria,0,1,1,2,0,ALG
2008_BAH,2008,68,Bahamas,0,1,1,2,0,BAH
2008_MAR,2008,68,Morocco,0,1,1,2,0,MAR
2008_TJK,2008,68,Tajikistan,0,1,1,2,0,TJK
2008_CHI,2008,72,Chile,0,1,0,1,0,CHI
2008_ECU,2008,72,Ecuador,0,1,0,1,0,ECU
2008_ISL,2008,72,Iceland,0,1,0,1,0,ISL
2008_MAS,2008,72,Malaysia,0,1,0,1,0,MAS
2008_SAM,2008,72,Samoa,0,1,0,1,0,SAM
2008_SIN,2008,72,Singapore,0,1,0,1,0,SIN
2008_RSA,2008,72,South Africa,0,1,0,1,0,RSA
2008_SUD,2008,72,Sudan,0,1,0,1,0,SUD
2008_VIE,2008,72,Vietnam,0,1,0,1,0,VIE
2008_EGY,2008,81,Egypt,0,0,2,2,0,EGY
2008_AFG,2008,82,Afghanistan,0,0,1,1,0,AFG
2008_ISR,2008,82,Israel,0,0,1,1,0,ISR
2008_MRI,2008,82,Mauritius,0,0,1,1,0,MRI
2008_MDA,2008,82,Moldova,0,0,1,1,0,MDA
2008_TOG,2008,82,Togo,0,0,1,1,0,TOG
2008_VEN,2008,82,Venezuela,0,0,1,1,0,VEN
2012_USA,2012,1,United States,48,26,31,105,0,USA
2012_CHN,2012,2,China,39,31,22,92,0,CHN
2012_GBR,2012,3,Great Britain,29,18,18,65,0,GBR
2012_RUS,2012,4,Russia,18,20,26,64,0,RUS
2012_RUS,2012,4,Russia,18,20,26,64,0,RUS
2012_KOR,2012,5,South Korea,13,9,9,31,0,KOR
2012_GER,2012,6,Germany,11,20,13,44,0,GER
2012_GER,2012,6,Germany,11,20,13,44,0,GER
2012_GER,2012,6,Germany,11,20,13,44,0,GER
2012_FRA,2012,7,France,11,11,13,35,0,FRA
2012_AUS,2012,8,Australia,8,15,12,35,0,AUS
2012_ITA,2012,9,Italy,8,9,11,28,0,ITA
2012_HUN,2012,10,Hungary,8,4,6,18,0,HUN
2012_JPN,2012,11,Japan,7,14,17,38,0,JPN
2012_IRI,2012,12,Iran,7,5,1,13,0,IRI
2012_NED,2012,13,Netherlands,6,6,8,20,0,NED
2012_NZL,2012,14,New Zealand,6,2,5,13,0,NZL
2012_UKR,2012,15,Ukraine,5,4,10,19,0,UKR
2012_CUB,2012,16,Cuba,5,3,7,15,0,CUB
2012_ESP,2012,17,Spain,4,10,6,20,0,ESP
2012_JAM,2012,18,Jamaica,4,5,4,13,0,JAM
2012_CZE,2012,19,Czech Republic,4,4,3,11,0,CZE
2012_CZE,2012,19,Czech Republic,4,4,3,11,0,CZE
2012_RSA,2012,20,South Africa,4,1,1,6,0,RSA
2012_PRK,2012,21,North Korea,4,0,2,6,0,PRK
2012_BRA,2012,22,Brazil,3,5,9,17,0,BRA
2012_KAZ,2012,23,Kazakhstan,3,2,6,11,0,KAZ
2012_POL,2012,23,Poland,3,2,6,11,0,POL
2012_ETH,2012,25,Ethiopia,3,2,3,8,0,ETH
2012_CRO,2012,26,Croatia,3,1,2,6,0,CRO
2012_CAN,2012,27,Canada,2,6,10,18,0,CAN
2012_BLR,2012,28,Belarus,2,5,3,10,0,BLR
2012_KEN,2012,29,Kenya,2,4,7,13,0,KEN
2012_DEN,2012,30,Denmark,2,4,3,9,0,DEN
2012_ROU,2012,31,Romania,2,4,1,7,0,ROU
2012_AZE,2012,32,Azerbaijan,2,2,5,9,0,AZE
2012_SUI,2012,33,Switzerland,2,2,0,4,0,SUI
2012_NOR,2012,34,Norway,2,1,1,4,0,NOR
2012_LTU,2012,35,Lithuania,2,0,3,5,0,LTU
2012_TUN,2012,36,Tunisia,2,0,1,3,0,TUN
2012_SWE,2012,37,Sweden,1,4,3,8,0,SWE
2012_COL,2012,38,Colombia,1,3,5,9,0,COL
2012_MEX,2012,39,Mexico,1,3,4,8,0,MEX
2012_GEO,2012,40,Georgia,1,2,3,6,0,GEO
2012_IRL,2012,41,Ireland,1,1,4,6,0,IRL
2012_ARG,2012,42,Argentina,1,1,2,4,0,ARG
2012_SRB,2012,42,Serbia,1,1,2,4,0,SRB
2012_SLO,2012,42,Slovenia,1,1,2,4,0,SLO
2012_TTO,2012,42,Trinidad and Tobago,1,1,2,4,0,TTO
2012_TUR,2012,46,Turkey,1,1,1,3,0,TUR
2012_DOM,2012,47,Dominican Republic,1,1,0,2,0,DOM
2012_Unknown,2012,48,Chinese Taipei,1,0,1,2,0,NA
2012_LAT,2012,48,Latvia,1,0,1,2,0,LAT
2012_ALG,2012,50,Algeria,1,0,0,1,0,ALG
2012_BAH,2012,50,Bahamas,1,0,0,1,0,BAH
2012_BRN,2012,50,Bahrain,1,0,0,1,0,BRN
2012_GRN,2012,50,Grenada,1,0,0,1,0,GRN
2012_UGA,2012,50,Uganda,1,0,0,1,0,UGA
2012_VEN,2012,50,Venezuela,1,0,0,1,0,VEN
2012_EGY,2012,56,Egypt,0,3,1,4,0,EGY
2012_IND,2012,57,India,0,2,4,6,0,IND
2012_MGL,2012,58,Mongolia,0,2,3,5,0,MGL
2012_THA,2012,59,Thailand,0,2,2,4,0,THA
2012_BUL,2012,60,Bulgaria,0,2,1,3,0,BUL
2012_FIN,2012,60,Finland,0,2,1,3,0,FIN
2012_INA,2012,60,Indonesia,0,2,1,3,0,INA
2012_SVK,2012,63,Slovakia,0,1,3,4,0,SVK
2012_BEL,2012,64,Belgium,0,1,2,3,0,BEL
2012_ARM,2012,65,Armenia,0,1,1,2,0,ARM
2012_EST,2012,65,Estonia,0,1,1,2,0,EST
2012_MAS,2012,65,Malaysia,0,1,1,2,0,MAS
2012_PUR,2012,65,Puerto Rico,0,1,1,2,0,PUR
2012_QAT,2012,65,Qatar,0,1,1,2,0,QAT
2012_BOT,2012,70,Botswana,0,1,0,1,0,BOT
2012_CYP,2012,70,Cyprus,0,1,0,1,0,CYP
2012_GAB,2012,70,Gabon,0,1,0,1,0,GAB
2012_GUA,2012,70,Guatemala,0,1,0,1,0,GUA
2012_MNE,2012,70,Montenegro,0,1,0,1,0,MNE
2012_POR,2012,70,Portugal,0,1,0,1,0,POR
2012_UZB,2012,76,Uzbekistan,0,0,3,3,0,UZB
2012_GRE,2012,77,Greece,0,0,2,2,0,GRE
2012_SIN,2012,77,Singapore,0,0,2,2,0,SIN
2012_AFG,2012,79,Afghanistan,0,0,1,1,0,AFG
2012_CMR,2012,79,Cameroon,0,0,1,1,0,CMR
2012_Unknown,2012,79,Hong Kong,0,0,1,1,0,NA
2012_KUW,2012,79,Kuwait,0,0,1,1,0,KUW
2012_MAR,2012,79,Morocco,0,0,1,1,0,MAR
2012_KSA,2012,79,Saudi Arabia,0,0,1,1,0,KSA
2012_TJK,2012,79,Tajikistan,0,0,1,1,0,TJK
2012_VIE,2012,79,Vietnam,0,0,1,1,0,VIE
2016_USA,2016,1,United States,46,37,38,121,0,USA
2016_GBR,2016,2,Great Britain,27,23,17,67,0,GBR
2016_CHN,2016,3,China,26,18,26,70,0,CHN
2016_RUS,2016,4,Russia,19,17,20,56,0,RUS
2016_RUS,2016,4,Russia,19,17,20,56,0,RUS
2016_GER,2016,5,Germany,17,10,15,42,0,GER
2016_GER,2016,5,Germany,17,10,15,42,0,GER
2016_GER,2016,5,Germany,17,10,15,42,0,GER
2016_JPN,2016,6,Japan,12,8,21,41,0,JPN
2016_FRA,2016,7,France,10,18,14,42,0,FRA
2016_KOR,2016,8,South Korea,9,3,9,21,0,KOR
2016_ITA,2016,9,Italy,8,12,8,28,0,ITA
2016_AUS,2016,10,Australia,8,11,10,29,0,AUS
2016_NED,2016,11,Netherlands,8,7,4,19,0,NED
2016_HUN,2016,12,Hungary,8,3,4,15,0,HUN
2016_BRA,2016,13,Brazil,7,6,6,19,1,BRA
2016_ESP,2016,14,Spain,7,4,6,17,0,ESP
2016_KEN,2016,15,Kenya,6,6,1,13,0,KEN
2016_JAM,2016,16,Jamaica,6,3,2,11,0,JAM
2016_CRO,2016,17,Croatia,5,3,2,10,0,CRO
2016_CUB,2016,18,Cuba,5,2,4,11,0,CUB
2016_NZL,2016,19,New Zealand,4,9,5,18,0,NZL
2016_CAN,2016,20,Canada,4,3,15,22,0,CAN
2016_UZB,2016,21,Uzbekistan,4,2,7,13,0,UZB
2016_COL,2016,22,Colombia,3,2,3,8,0,COL
2016_SUI,2016,23,Switzerland,3,2,2,7,0,SUI
2016_IRI,2016,24,Iran,3,1,4,8,0,IRI
2016_GRE,2016,25,Greece,3,1,2,6,0,GRE
2016_ARG,2016,26,Argentina,3,1,0,4,0,ARG
2016_DEN,2016,27,Denmark,2,6,7,15,0,DEN
2016_SWE,2016,28,Sweden,2,6,3,11,0,SWE
2016_RSA,2016,29,South Africa,2,6,2,10,0,RSA
2016_KAZ,2016,30,Kazakhstan,2,5,10,17,0,KAZ
2016_UKR,2016,31,Ukraine,2,5,4,11,0,UKR
2016_SRB,2016,32,Serbia,2,4,2,8,0,SRB
2016_POL,2016,33,Poland,2,3,6,11,0,POL
2016_PRK,2016,34,North Korea,2,3,2,7,0,PRK
2016_BEL,2016,35,Belgium,2,2,2,6,0,BEL
2016_THA,2016,35,Thailand,2,2,2,6,0,THA
2016_SVK,2016,37,Slovakia,2,2,0,4,0,SVK
2016_GEO,2016,38,Georgia,2,1,4,7,0,GEO
2016_AZE,2016,39,Azerbaijan,1,7,10,18,0,AZE
2016_BLR,2016,40,Belarus,1,4,4,9,0,BLR
2016_TUR,2016,41,Turkey,1,3,4,8,0,TUR
2016_ARM,2016,42,Armenia,1,3,0,4,0,ARM
2016_CZE,2016,43,Czech Republic,1,2,7,10,0,CZE
2016_CZE,2016,43,Czech Republic,1,2,7,10,0,CZE
2016_ETH,2016,44,Ethiopia,1,2,5,8,0,ETH
2016_SLO,2016,45,Slovenia,1,2,1,4,0,SLO
2016_INA,2016,46,Indonesia,1,2,0,3,0,INA
2016_ROU,2016,47,Romania,1,1,2,4,0,ROU
2016_BRN,2016,48,Bahrain,1,1,0,2,0,BRN
2016_VIE,2016,48,Vietnam,1,1,0,2,0,VIE
2016_Unknown,2016,50,Chinese Taipei,1,0,2,3,0,NA
2016_BAH,2016,51,Bahamas,1,0,1,2,0,BAH
2016_Unknown,2016,51,Independent Olympic Athletes,1,0,1,2,0,NA
2016_CIV,2016,51,Ivory Coast,1,0,1,2,0,CIV
2016_FIJ,2016,54,Fiji,1,0,0,1,0,FIJ
2016_JOR,2016,54,Jordan,1,0,0,1,0,JOR
2016_KOS,2016,54,Kosovo,1,0,0,1,0,KOS
2016_PUR,2016,54,Puerto Rico,1,0,0,1,0,PUR
2016_SIN,2016,54,Singapore,1,0,0,1,0,SIN
2016_TJK,2016,54,Tajikistan,1,0,0,1,0,TJK
2016_MAS,2016,60,Malaysia,0,4,1,5,0,MAS
2016_MEX,2016,61,Mexico,0,3,2,5,0,MEX
2016_VEN,2016,62,Venezuela,0,2,1,3,0,VEN
2016_ALG,2016,63,Algeria,0,2,0,2,0,ALG
2016_IRL,2016,63,Ireland,0,2,0,2,0,IRL
2016_LTU,2016,65,Lithuania,0,1,3,4,0,LTU
2016_BUL,2016,66,Bulgaria,0,1,2,3,0,BUL
2016_IND,2016,67,India,0,1,1,2,0,IND
2016_MGL,2016,67,Mongolia,0,1,1,2,0,MGL
2016_BDI,2016,69,Burundi,0,1,0,1,0,BDI
2016_GRN,2016,69,Grenada,0,1,0,1,0,GRN
2016_NIG,2016,69,Niger,0,1,0,1,0,NIG
2016_PHI,2016,69,Philippines,0,1,0,1,0,PHI
2016_QAT,2016,69,Qatar,0,1,0,1,0,QAT
2016_NOR,2016,74,Norway,0,0,4,4,0,NOR
2016_EGY,2016,75,Egypt,0,0,3,3,0,EGY
2016_TUN,2016,75,Tunisia,0,0,3,3,0,TUN
2016_ISR,2016,77,Israel,0,0,2,2,0,ISR
2016_AUT,2016,78,Austria,0,0,1,1,0,AUT
2016_DOM,2016,78,Dominican Republic,0,0,1,1,0,DOM
2016_EST,2016,78,Estonia,0,0,1,1,0,EST
2016_FIN,2016,78,Finland,0,0,1,1,0,FIN
2016_MAR,2016,78,Morocco,0,0,1,1,0,MAR
2016_NGR,2016,78,Nigeria,0,0,1,1,0,NGR
2016_POR,2016,78,Portugal,0,0,1,1,0,POR
2016_TTO,2016,78,Trinidad and Tobago,0,0,1,1,0,TTO
2016_UAE,2016,78,United Arab Emirates,0,0,1,1,0,UAE
2020_USA,2020,1,United States,39,41,33,113,0,USA
2020_CHN,2020,2,China,38,32,19,89,0,CHN
2020_JPN,2020,3,Japan,27,14,17,58,1,JPN
2020_GBR,2020,4,Great Britain,22,20,22,64,0,GBR
2020_Unknown,2020,5,ROC,20,28,23,71,0,NA
2020_AUS,2020,6,Australia,17,7,22,46,0,AUS
2020_NED,2020,7,Netherlands,10,12,14,36,0,NED
2020_FRA,2020,8,France,10,12,11,33,0,FRA
2020_GER,2020,9,Germany,10,11,16,37,0,GER
2020_GER,2020,9,Germany,10,11,16,37,0,GER
2020_GER,2020,9,Germany,10,11,16,37,0,GER
2020_ITA,2020,10,Italy,10,10,20,40,0,ITA
2020_CAN,2020,11,Canada,7,7,10,24,0,CAN
2020_BRA,2020,12,Brazil,7,6,8,21,0,BRA
2020_NZL,2020,13,New Zealand,7,6,7,20,0,NZL
2020_CUB,2020,14,Cuba,7,3,5,15,0,CUB
2020_HUN,2020,15,Hungary,6,7,7,20,0,HUN
2020_KOR,2020,16,South Korea,6,4,10,20,0,KOR
2020_POL,2020,17,Poland,4,5,5,14,0,POL
2020_CZE,2020,18,Czech Republic,4,4,3,11,0,CZE
2020_CZE,2020,18,Czech Republic,4,4,3,11,0,CZE
2020_KEN,2020,19,Kenya,4,4,2,10,0,KEN
2020_NOR,2020,20,Norway,4,2,2,8,0,NOR
2020_JAM,2020,21,Jamaica,4,1,4,9,0,JAM
2020_ESP,2020,22,Spain,3,8,6,17,0,ESP
2020_SWE,2020,23,Sweden,3,6,0,9,0,SWE
2020_SUI,2020,24,Switzerland,3,4,6,13,0,SUI
2020_DEN,2020,25,Denmark,3,4,4,11,0,DEN
2020_CRO,2020,26,Croatia,3,3,2,8,0,CRO
2020_IRI,2020,27,Iran,3,2,2,7,0,IRI
2020_SRB,2020,28,Serbia,3,1,5,9,0,SRB
2020_BEL,2020,29,Belgium,3,1,3,7,0,BEL
2020_BUL,2020,30,Bulgaria,3,1,2,6,0,BUL
2020_SLO,2020,31,Slovenia,3,1,1,5,0,SLO
2020_UZB,2020,32,Uzbekistan,3,0,2,5,0,UZB
2020_GEO,2020,33,Georgia,2,5,1,8,0,GEO
2020_Unknown,2020,34,Chinese Taipei,2,4,6,12,0,NA
2020_TUR,2020,35,Turkey,2,2,9,13,0,TUR
2020_GRE,2020,36,Greece,2,1,1,4,0,GRE
2020_UGA,2020,36,Uganda,2,1,1,4,0,UGA
2020_ECU,2020,38,Ecuador,2,1,0,3,0,ECU
2020_IRL,2020,39,Ireland,2,0,2,4,0,IRL
2020_ISR,2020,39,Israel,2,0,2,4,0,ISR
2020_QAT,2020,41,Qatar,2,0,1,3,0,QAT
2020_BAH,2020,42,Bahamas,2,0,0,2,0,BAH
2020_KOS,2020,42,Kosovo,2,0,0,2,0,KOS
2020_UKR,2020,44,Ukraine,1,6,12,19,0,UKR
2020_BLR,2020,45,Belarus,1,3,3,7,0,BLR
2020_ROU,2020,46,Romania,1,3,0,4,0,ROU
2020_VEN,2020,46,Venezuela,1,3,0,4,0,VEN
2020_IND,2020,48,India,1,2,4,7,0,IND
2020_Unknown,2020,49,Hong Kong,1,2,3,6,0,NA
2020_PHI,2020,50,Philippines,1,2,1,4,0,PHI
2020_SVK,2020,50,Slovakia,1,2,1,4,0,SVK
2020_RSA,2020,52,South Africa,1,2,0,3,0,RSA
2020_AUT,2020,53,Austria,1,1,5,7,0,AUT
2020_EGY,2020,54,Egypt,1,1,4,6,0,EGY
2020_INA,2020,55,Indonesia,1,1,3,5,0,INA
2020_ETH,2020,56,Ethiopia,1,1,2,4,0,ETH
2020_POR,2020,56,Portugal,1,1,2,4,0,POR
2020_TUN,2020,58,Tunisia,1,1,0,2,0,TUN
2020_EST,2020,59,Estonia,1,0,1,2,0,EST
2020_FIJ,2020,59,Fiji,1,0,1,2,0,FIJ
2020_LAT,2020,59,Latvia,1,0,1,2,0,LAT
2020_THA,2020,59,Thailand,1,0,1,2,0,THA
2020_BER,2020,63,Bermuda,1,0,0,1,0,BER
2020_MAR,2020,63,Morocco,1,0,0,1,0,MAR
2020_PUR,2020,63,Puerto Rico,1,0,0,1,0,PUR
2020_COL,2020,66,Colombia,0,4,1,5,0,COL
2020_AZE,2020,67,Azerbaijan,0,3,4,7,0,AZE
2020_DOM,2020,68,Dominican Republic,0,3,2,5,0,DOM
2020_ARM,2020,69,Armenia,0,2,2,4,0,ARM
2020_KGZ,2020,70,Kyrgyzstan,0,2,1,3,0,KGZ
2020_MGL,2020,71,Mongolia,0,1,3,4,0,MGL
2020_ARG,2020,72,Argentina,0,1,2,3,0,ARG
2020_SMR,2020,72,San Marino,0,1,2,3,0,SMR
2020_JOR,2020,74,Jordan,0,1,1,2,0,JOR
2020_MAS,2020,74,Malaysia,0,1,1,2,0,MAS
2020_NGR,2020,74,Nigeria,0,1,1,2,0,NGR
2020_BRN,2020,77,Bahrain,0,1,0,1,0,BRN
2020_LTU,2020,77,Lithuania,0,1,0,1,0,LTU
2020_NAM,2020,77,Namibia,0,1,0,1,0,NAM
2020_Unknown,2020,77,North Macedonia,0,1,0,1,0,NA
2020_KSA,2020,77,Saudi Arabia,0,1,0,1,0,KSA
2020_TKM,2020,77,Turkmenistan,0,1,0,1,0,TKM
2020_KAZ,2020,83,Kazakhstan,0,0,8,8,0,KAZ
2020_MEX,2020,84,Mexico,0,0,4,4,0,MEX
2020_FIN,2020,85,Finland,0,0,2,2,0,FIN
2020_BOT,2020,86,Botswana,0,0,1,1,0,BOT
2020_BUR,2020,86,Burkina Faso,0,0,1,1,0,BUR
2020_GHA,2020,86,Ghana,0,0,1,1,0,GHA
2020_GRN,2020,86,Grenada,0,0,1,1,0,GRN
2020_CIV,2020,86,Ivory Coast,0,0,1,1,0,CIV
2020_KUW,2020,86,Kuwait,0,0,1,1,0,KUW
2020_MDA,2020,86,Moldova,0,0,1,1,0,MDA
2020_SYR,2020,86,Syria,0,0,1,1,0,SYR
2020_UAR,2020,86,Syria,0,0,1,1,0,UAR
2024_USA,2024,1,United States,40,44,42,126,0,USA
2024_CHN,2024,2,China,40,27,24,91,0,CHN
2024_JPN,2024,3,Japan,20,12,13,45,0,JPN
2024_AUS,2024,4,Australia,18,19,16,53,0,AUS
2024_FRA,2024,5,France,16,26,22,64,1,FRA
2024_NED,2024,6,Netherlands,15,7,12,34,0,NED
2024_GBR,2024,7,Great Britain,14,22,29,65,0,GBR
2024_KOR,2024,8,South Korea,13,9,10,32,0,KOR
2024_ITA,2024,9,Italy,12,13,15,40,0,ITA
2024_GER,2024,10,Germany,12,13,8,33,0,GER
2024_GER,2024,10,Germany,12,13,8,33,0,GER
2024_GER,2024,10,Germany,12,13,8,33,0,GER
2024_NZL,2024,11,New Zealand,10,7,3,20,0,NZL
2024_CAN,2024,12,Canada,9,7,11,27,0,CAN
2024_UZB,2024,13,Uzbekistan,8,2,3,13,0,UZB
2024_HUN,2024,14,Hungary,6,7,6,19,0,HUN
2024_ESP,2024,15,Spain,5,4,9,18,0,ESP
2024_SWE,2024,16,Sweden,4,4,3,11,0,SWE
2024_KEN,2024,17,Kenya,4,2,5,11,0,KEN
2024_NOR,2024,18,Norway,4,1,3,8,0,NOR
2024_IRL,2024,19,Ireland,4,0,3,7,0,IRL
2024_BRA,2024,20,Brazil,3,7,10,20,0,BRA
2024_IRI,2024,21,Iran,3,6,3,12,0,IRI
2024_UKR,2024,22,Ukraine,3,5,4,12,0,UKR
2024_ROU,2024,23,Romania,3,4,2,9,0,ROU
2024_GEO,2024,24,Georgia,3,3,1,7,0,GEO
2024_BEL,2024,25,Belgium,3,1,6,10,0,BEL
2024_BUL,2024,26,Bulgaria,3,1,3,7,0,BUL
2024_SRB,2024,27,Serbia,3,1,1,5,0,SRB
2024_CZE,2024,28,Czech Republic,3,0,2,5,0,CZE
2024_CZE,2024,28,Czech Republic,3,0,2,5,0,CZE
2024_DEN,2024,29,Denmark,2,2,5,9,0,DEN
2024_AZE,2024,30,Azerbaijan,2,2,3,7,0,AZE
2024_CRO,2024,30,Croatia,2,2,3,7,0,CRO
2024_CUB,2024,32,Cuba,2,1,6,9,0,CUB
2024_BRN,2024,33,Bahrain,2,1,1,4,0,BRN
2024_SLO,2024,34,Slovenia,2,1,0,3,0,SLO
2024_Unknown,2024,35,Chinese Taipei,2,0,5,7,0,NA
2024_AUT,2024,36,Austria,2,0,3,5,0,AUT
2024_Unknown,2024,37,Hong Kong,2,0,2,4,0,NA
2024_PHI,2024,37,Philippines,2,0,2,4,0,PHI
2024_ALG,2024,39,Algeria,2,0,1,3,0,ALG
2024_INA,2024,39,Indonesia,2,0,1,3,0,INA
2024_ISR,2024,41,Israel,1,5,1,7,0,ISR
2024_POL,2024,42,Poland,1,4,5,10,0,POL
2024_KAZ,2024,43,Kazakhstan,1,3,3,7,0,KAZ
2024_JAM,2024,44,Jamaica,1,3,2,6,0,JAM
2024_RSA,2024,44,South Africa,1,3,2,6,0,RSA
2024_THA,2024,44,Thailand,1,3,2,6,0,THA
2024_Unknown,2024,NA,Individual Neutral Athletes,1,3,1,5,0,NA
2024_ETH,2024,47,Ethiopia,1,3,0,4,0,ETH
2024_SUI,2024,48,Switzerland,1,2,5,8,0,SUI
2024_ECU,2024,49,Ecuador,1,2,2,5,0,ECU
2024_POR,2024,50,Portugal,1,2,1,4,0,POR
2024_GRE,2024,51,Greece,1,1,6,8,0,GRE
2024_ARG,2024,52,Argentina,1,1,1,3,0,ARG
2024_EGY,2024,52,Egypt,1,1,1,3,0,EGY
2024_TUN,2024,52,Tunisia,1,1,1,3,0,TUN
2024_BOT,2024,55,Botswana,1,1,0,2,0,BOT
2024_CHI,2024,55,Chile,1,1,0,2,0,CHI
2024_LCA,2024,55,Saint Lucia,1,1,0,2,0,LCA
2024_UGA,2024,55,Uganda,1,1,0,2,0,UGA
2024_DOM,2024,59,Dominican Republic,1,0,2,3,0,DOM
2024_GUA,2024,60,Guatemala,1,0,1,2,0,GUA
2024_MAR,2024,60,Morocco,1,0,1,2,0,MAR
2024_DMA,2024,62,Dominica,1,0,0,1,0,DMA
2024_PAK,2024,62,Pakistan,1,0,0,1,0,PAK
2024_TUR,2024,64,Turkey,0,3,5,8,0,TUR
2024_MEX,2024,65,Mexico,0,3,2,5,0,MEX
2024_ARM,2024,66,Armenia,0,3,1,4,0,ARM
2024_COL,2024,66,Colombia,0,3,1,4,0,COL
2024_KGZ,2024,68,Kyrgyzstan,0,2,4,6,0,KGZ
2024_PRK,2024,68,North Korea,0,2,4,6,0,PRK
2024_LTU,2024,70,Lithuania,0,2,2,4,0,LTU
2024_IND,2024,71,India,0,1,5,6,0,IND
2024_MDA,2024,72,Moldova,0,1,3,4,0,MDA
2024_KOS,2024,73,Kosovo,0,1,1,2,0,KOS
2024_CYP,2024,74,Cyprus,0,1,0,1,0,CYP
2024_FIJ,2024,74,Fiji,0,1,0,1,0,FIJ
2024_JOR,2024,74,Jordan,0,1,0,1,0,JOR
2024_MGL,2024,74,Mongolia,0,1,0,1,0,MGL
2024_PAN,2024,74,Panama,0,1,0,1,0,PAN
2024_TJK,2024,79,Tajikistan,0,0,3,3,0,TJK
2024_ALB,2024,80,Albania,0,0,2,2,0,ALB
2024_GRN,2024,80,Grenada,0,0,2,2,0,GRN
2024_MAS,2024,80,Malaysia,0,0,2,2,0,MAS
2024_PUR,2024,80,Puerto Rico,0,0,2,2,0,PUR
2024_CPV,2024,84,Cape Verde,0,0,1,1,0,CPV
2024_CIV,2024,84,Ivory Coast,0,0,1,1,0,CIV
2024_PER,2024,84,Peru,0,0,1,1,0,PER
2024_QAT,2024,84,Qatar,0,0,1,1,0,QAT
2024_Unknown,2024,84,Refugee Olympic Team,0,0,1,1,0,NA
2024_SIN,2024,84,Singapore,0,0,1,1,0,SIN
2024_SVK,2024,84,Slovakia,0,0,1,1,0,SVK
2024_ZAM,2024,84,Zambia,0,0,1,1,0,ZAM
1932_USA,1932,1,United States,44,36,30,110,1,USA
1932_ITA,1932,2,Italy,12,12,12,36,0,ITA
1932_FRA,1932,3,France,11,5,4,20,0,FRA
1932_SWE,1932,4,Sweden,10,5,9,24,0,SWE
1932_JPN,1932,5,Japan,7,7,4,18,0,JPN
1932_HUN,1932,6,Hungary,6,5,5,16,0,HUN
1932_FIN,1932,7,Finland,5,8,12,25,0,FIN
1932_GBR,1932,8,Great Britain,5,7,5,17,0,GBR
1932_GER,1932,9,Germany,3,12,7,22,0,GER
1932_GER,1932,9,Germany,3,12,7,22,0,GER
1932_GER,1932,9,Germany,3,12,7,22,0,GER
1932_POL,1932,10,Poland,3,2,4,9,0,POL
1932_AUS,1932,11,Australia,3,1,1,5,0,AUS
1932_ARG,1932,12,Argentina,3,1,0,4,0,ARG
1932_CAN,1932,13,Canada,2,5,9,16,0,CAN
1932_NED,1932,14,Netherlands,2,5,1,8,0,NED
1932_RSA,1932,15,South Africa,2,0,3,5,0,RSA
1932_IRL,1932,16,Ireland,2,0,0,2,0,IRL
1932_CZE,1932,17,Czechoslovakia,1,3,2,6,0,CZE
1932_AUT,1932,18,Austria,1,1,3,5,0,AUT
1932_IND,1932,19,India,1,0,0,1,0,IND
1932_DEN,1932,20,Denmark,0,5,3,8,0,DEN
1932_MEX,1932,21,Mexico,0,2,0,2,0,MEX
1932_LAT,1932,22,Latvia,0,1,0,1,0,LAT
1932_NZL,1932,22,New Zealand,0,1,0,1,0,NZL
1932_SUI,1932,22,Switzerland,0,1,0,1,0,SUI
1932_PHI,1932,25,Philippines,0,0,3,3,0,PHI
1932_BEL,1932,26,Belgium,0,0,1,1,0,BEL
1932_ESP,1932,26,Spain,0,0,1,1,0,ESP
1932_URU,1932,26,Uruguay,0,0,1,1,0,URU
1960_RUS,1960,1,Soviet Union,43,29,31,103,0,RUS
1960_USA,1960,2,United States,34,21,16,71,0,USA
1960_ITA,1960,3,Italy,13,10,13,36,0,ITA
1960_GER,1960,4,United Team of Germany,12,19,11,42,0,GER
1960_AUS,1960,5,Australia,8,8,6,22,0,AUS
1960_TUR,1960,6,Turkey,7,2,0,9,0,TUR
1960_HUN,1960,7,Hungary,6,8,7,21,0,HUN
1960_JPN,1960,8,Japan,4,7,7,18,0,JPN
1960_POL,1960,9,Poland,4,6,11,21,0,POL
1960_CZE,1960,10,Czechoslovakia,3,2,3,8,0,CZE
1960_ROU,1960,11,Romania,3,1,6,10,0,ROU
1960_GBR,1960,12,Great Britain,2,6,12,20,0,GBR
1960_DEN,1960,13,Denmark,2,3,1,6,0,DEN
1960_NZL,1960,14,New Zealand,2,0,1,3,0,NZL
1960_BUL,1960,15,Bulgaria,1,3,3,7,0,BUL
1960_SWE,1960,16,Sweden,1,2,3,6,0,SWE
1960_FIN,1960,17,Finland,1,1,3,5,0,FIN
1960_AUT,1960,18,Austria,1,1,0,2,0,AUT
1960_SRB,1960,18,Yugoslavia,1,1,0,2,0,SRB
1960_PAK,1960,20,Pakistan,1,0,1,2,0,PAK
1960_ETH,1960,21,Ethiopia,1,0,0,1,0,ETH
1960_GRE,1960,21,Greece,1,0,0,1,0,GRE
1960_NOR,1960,21,Norway,1,0,0,1,0,NOR
1960_SUI,1960,24,Switzerland,0,3,3,6,0,SUI
1960_FRA,1960,25,France,0,2,3,5,0,FRA
1960_BEL,1960,26,Belgium,0,2,2,4,0,BEL
1960_IRI,1960,27,Iran,0,1,3,4,0,IRI
1960_NED,1960,28,Netherlands,0,1,2,3,0,NED
1960_RSA,1960,28,South Africa,0,1,2,3,0,RSA
1960_ARG,1960,30,Argentina,0,1,1,2,0,ARG
1960_EGY,1960,30,Egypt,0,1,1,2,0,EGY
1960_CAN,1960,32,Canada,0,1,0,1,0,CAN
1960_Unknown,1960,32,Formosa,0,1,0,1,0,NA
1960_GHA,1960,32,Ghana,0,1,0,1,0,GHA
1960_IND,1960,32,India,0,1,0,1,0,IND
1960_MAR,1960,32,Morocco,0,1,0,1,0,MAR
1960_POR,1960,32,Portugal,0,1,0,1,0,POR
1960_SIN,1960,32,Singapore,0,1,0,1,0,SIN
1960_BRA,1960,39,Brazil,0,0,2,2,0,BRA
1960_Unknown,1960,39,British West Indies,0,0,2,2,0,NA
1960_IRQ,1960,41,Iraq,0,0,1,1,0,IRQ
1960_MEX,1960,41,Mexico,0,0,1,1,0,MEX
1960_ESP,1960,41,Spain,0,0,1,1,0,ESP
1960_VEN,1960,41,Venezuela,0,0,1,1,0,VEN
